av|אָב
aba|אַבָּא
aviv|אָבִיב
ev|אֵב
le'evod|לֶאֱבוֹד
lehe'aved|לְהֵיאָבֵד
le'abed|לְאַבֵּד
lehit'abed|לְהִתְאַבֵּד
leha'avid|לְהַאֲבִיד
hit'abdut|הִתְאַבְּדוּת
ibud|אִיבּוּד
aveda|אֲבֵדָה
avud|אָבוּד
le'avchen|לְאַבְחֵן
ivchun|אִיבְחוּן
le'avteach|לְאַבְטֵחַ
ivtuach|אִיבְטוּחַ
avatiach|אֲבַטִּיחַ
le'evot|לֶאֱבוֹת
evel|אֵבֶל
le'evol|לֶאֱבוֹל
aval|אֲבָל
lehit'abel|לְהִתְאַבֵּל
lehit'aben|לְהִתְאַבֵּן
even|אֶבֶן
leha'avis|לְהַאֲבִיס
lehe'avek|לְהֵיאָבֵק
ma'avak|מַאֲבָק
le'abek|לְאַבֵּק
avak|אָבָק
lehit'abek|לְהִתְאַבֵּק
lehit'abek|לְהִתְאַבֵּק
me'ubak|מְאוּבָּק
ibuk|אִיבּוּק
leha'avik|לְהַאֲבִיק
abir|אַבִּיר
le'egod|לֶאֱגוֹד
le'aged|לְאַגֵּד
lehe'aged|לְהֵיאָגֵד
lehit'aged|לְהִתְאַגֵּד
eged|אֶגֶד
aguda|אֲגוּדָּה
agida|אֲגִידָה
ugda|אוּגְדָּה
hit'agdut|הִתְאַגְּדוּת
igud|אִיגּוּד
egoz|אֱגוֹז
agam|אֲגַם
le'egof|לֶאֱגוֹף
le'agef|לְאַגֵּף
agaf|אֲגַף
iguf|אִיגּוּף
egron|אֶגְרוֹן
ma'agar|מַאֲגָר
igeret|אִיגֶּרֶת
le'egor|לֶאֱגוֹר
lehit'agref|לְהִתְאַגְרֵף
lehit'adot|לְהִתְאַדּוֹת
iduy|אִידּוּי
hit'adut|הִתְאַדּוּת
ed|אֵד
le'adot|לְאַדּוֹת
ma'adim|מַאֲדִים
adamdam|אֲדַמְדַּם
ademet|אַדֶּמֶת
adam|אָדָם
adom|אָדוֹם
adama|אֲדָמָה
leha'adim|לְהַאֲדִים
ne'edar|נֶאְדָּר
adir|אַדִּיר
le'ehov|לֶאֱהוֹב
lehit'ahev|לְהִתְאַהֵב
ahava|אַהֲבָה
ahuv|אָהוּב
me'ohav|מְאוֹהָב
lehe'ahev|לְהֵיאָהֵב
ohed|אוֹהֵד
le'ehod|לֶאֱהוֹד
le'ehoah|לֶאֱהוֹהַּ
ohel|אוֹהֶל
o|אוֹ
avir|אֲווִיר
leha'it|לְהָאִיט
ta'ava|תַּאֲווָה
le'avot|לְאַוּוֹת
lehit'avot|לְהִתְאַוּוֹת
uchlusiya|אוּכְלוּסִיָּה
ulay|אוּלַי
universita|אוּנִיבֶרְסִיטָה
la'utz|לָאוּץ
leha'itz|לְהָאִיץ
leha'ir|לְהָאִיר
or|אוֹר
te'ura|תְּאוּרָה
me'ura|מְאוּרָה
ma'or|מָאוֹר
le'avrer|לְאַווְרֵר
lehit'avrer|לְהִתְאַווְרֵר
ivrur|אִיווְרוּר
le'avshesh|לְאַווְשֵׁשׁ
ivshush|אִיווְשׁוּשׁ
lehe'ot|לְהֵיאוֹת
le'otet|לְאוֹתֵת
ot|אוֹת
ot|אוֹת
az|אָז
le'azker|לְאַזְכֵּר
le'ezol|לֶאֱזוֹל
leha'azin|לְהַאֲזִין
le'azen|לְאַזֵּן
lehit'azen|לְהִתְאַזֵּן
ozen|אוֹזֶן
ha'azana|הַאֲזָנָה
izun|אִיזּוּן
le'ezok|לֶאֱזוֹק
lehit'azer|לְהִתְאַזֵּר
ezor|אֵזוֹר
le'ezor|לֶאֱזוֹר
ach|אָח
le'ached|לְאַחֵד
lehit'ached|לְהִתְאַחֵד
achdut|אַחְדוּת
ichud|אִיחוּד
hit'achadut|הִתְאַחֲדוּת
achid|אָחִיד
leha'achid|לְהַאֲחִיד
me'uchad|מְאוּחָד
ha'achada|הַאֲחָדָה
achot|אָחוֹת
le'echoz|לֶאֱחוֹז
lehe'achez|לְהֵיאָחֵז
achuz|אָחוּז
le'achot|לְאַחוֹת
lehit'achot|לְהִתְאַחוֹת
achyan|אַחְייָן
achyanit|אַחְייָנִית
le'achel|לְאַחֵל
le'achsen|לְאַחְסֵן
ichsun|אִיחְסוּן
le'acher|לְאַחֵר
achor|אָחוֹר
achar|אַחַר
achora|אָחוֹרָה
me'achorei|מֵאֲחוֹרֵי
achorayim|אֲחוֹרַייִם
acher|אַחֵר
acharon|אַחֲרוֹן
lehit'acher|לְהִתְאַחֵר
iti|אִיטִּי
at|אַט
leha'et|לְהָאֵט
le'etom|לֶאֱטוֹם
lehe'atem|לְהֵיאָטֵם
i|אִי
oyev|אוֹיֵב
eiva|אֵיבָה
eivar|אֵיבָר
le'ayed|לְאַייֵּד
aya|אַיָּה
eich|אֵיךְ
eichut|אֵיכוּת
ilu|אִילּוּ
iyum|אִיּוּם
le'ayem|לְאַייֵּם
eima|אֵימָה
ayom|אָיוֹם
ein|אֵין
le'ayen|לְאַייֵּן
eifo|אֵיפֹה
iyur|אִיּוּר
le'ayer|לְאַייֵּר
le'ayesh|לְאַייֵּשׁ
le'ayet|לְאַייֵּת
le'achzev|לְאַכְזֵב
lehit'achzev|לְהִתְאַכְזֵב
me'uchzav|מְאוּכְזָב
lehit'achzer|לְהִתְאַכְזֵר
le'echol|לֶאֱכוֹל
lehe'achel|לְהֵיאָכֵל
le'akel|לְאַכֵּל
leha'achil|לְהַאֲכִיל
ochel|אוֹכֶל
achlan|אַכְלָן
le'achles|לְאַכְלֵס
le'achsen|לְאַכְסֵן
lehit'achsen|לְהִתְאַכְסֵן
le'echof|לֶאֱכוֹף
lehe'achef|לְהֵיאָכֵף
ichpat|אִכְפַּת
el|אֶל
al|אַל
ele|אֵלֶה
ala|אַלָּה
elu|אֵלוּ
elohim|אֱלוֹהִים
le'alchesh|לְאַלְחֵשׁ
alachson|אֲלַכְסוֹן
lehe'alem|לְהֵיאָלֵם
alim|אַלִּים
ilem|אִילֵּם
almoni|אַלְמוֹנִי
lehit'almen|לְהִתְאַלְמֵן
le'alef|לְאַלֵּף
elef|אֶלֶף
aluf|אַלּוּף
lehe'aletz|לְהֵיאָלֵץ
le'aletz|לְאַלֵּץ
ilutz|אִילּוּץ
le'alter|לְאַלְתֵּר
em|אֵם
im|אִם
ima|אִמָּא
le'emod|לֶאֱמוֹד
lehe'amed|לְהֵיאָמֵד
amid|אָמִיד
le'amlel|לְאַמְלֵל
lehe'amen|לְהֵיאָמֵן
leha'amin|לְהַאֲמִין
lehit'amen|לְהִתְאַמֵּן
me'amen|מְאַמֵּן
uman|אוּמָּן
omnam|אוֹמְנָם
imun|אִימּוּן
le'amen|לְאַמֵּן
amin|אָמִין
oman|אוֹמָּן
omanut|אוֹמָּנוּת
emuna|אֱמוּנָה
amen|אָמֵן
umanut|אוּמָּנוּת
le'ametz|לְאַמֵּץ
lehit'ametz|לְהִתְאַמֵּץ
le'emotz|לֶאֱמוֹץ
amitz|אַמִּיץ
ma'amatz|מַאֲמָץ
ometz|אוֹמֶץ
amur|אָמוּר
lehe'amer|לְהֵיאָמֵר
leha'amir|לְהַאֲמִיר
imra|אִמְרָה
lomar|לוֹמַר
ma'amar|מַאֲמָר
leha'amir|לְהַאֲמִיר
le'amet|לְאַמֵּת
lehit'amet|לְהִתְאַמֵּת
amiti|אֲמִיתִּי
amita|אֲמִיתָּה
emet|אֱמֵת
imut|אִימּוּת
amitut|אֲמִיתּוּת
anu|אָנוּ
anochi|אֲנוֹכִי
lehe'aneach|לְהֵיאָנֵחַ
lehit'aneach|לְהִתְאַנֵּחַ
anachnu|אֲנַחְנוּ
ani|אֲנִי
le'anot|לְאַנּוֹת
oniya|אֳנִייָּה
lehit'onen|לְהִתְאוֹנֵן
le'onen|לְאוֹנֵן
le'enos|לֶאֱנוֹס
lehe'anes|לְהֵיאָנֵס
lehe'anek|לְהֵיאָנֵק
ishiyut|אִישִׁיּוּת
ishi|אִישִׁי
ishit|אִישִׁית
ish|אִישׁ
isha|אִישָּׁה
enosh|אֱנוֹשׁ
ason|אָסוֹן
astronomya|אַסְטְרוֹנוֹמְיָה
asla|אַסְלָה
lehit'aslem|לְהִתְאַסְלֵם
lehe'asef|לְהֵיאָסֵף
lehit'asef|לְהִתְאַסֵּף
osef|אוֹסֶף
asfan|אַסְפָן
le'esof|לֶאֱסוֹף
lehe'aser|לְהֵיאָסֵר
isur|אִיסּוּר
asur|אָסוּר
asir|אָסִיר
le'esor|לֶאֱסוֹר
lehe'afot|לְהֵיאָפוֹת
le'efot|לֶאֱפוֹת
afilu|אֲפִילּוּ
le'afyen|לְאַפְייֵן
lehit'afyen|לְהִתְאַפְייֵן
leha'afil|לְהַאֲפִיל
afel|אָפֵל
afela|אֲפֵלָה
ofna|אוֹפְנָה
ofen|אוֹפֶן
le'afnen|לְאַפְנֵן
le'efos|לֶאֱפוֹס
le'apes|לְאַפֵּס
efes|אֶפֶס
lehit'apes|לְהִתְאַפֵּס
afsi|אַפְסִי
le'efof|לֶאֱפוֹף
af|אַף
ofek|אוֹפֶק
lehit'apek|לְהִתְאַפֵּק
leha'afir|לְהַאֲפִיר
le'aper|לְאַפֵּר
lehit'aper|לְהִתְאַפֵּר
afor|אָפוֹר
lehit'afsher|לְהִתְאַפְשֵׁר
efshar|אֶפְשָׁר
le'afsher|לְאַפְשֵׁר
efsharut|אֶפְשָׁרוּת
efshari|אֶפְשָׁרִי
etzel|אֵצֶל
leha'atzil|לְהַאֲצִיל
otzar|אוֹצָר
le'etzor|לֶאֱצוֹר
lehit'aklem|לְהִתְאַקְלֵם
aruba|אֲרוּבָּה
le'erov|לֶאֱרוֹב
le'erog|לֶאֱרוֹג
lehe'areg|לְהֵיאָרֵג
le'argen|לְאַרְגֵּן
lehit'argen|לְהִתְאַרְגֵּן
irgun|אִירְגּוּן
aron|אָרוֹן
le'eroz|לֶאֱרוֹז
erez|אֶרֶז
ariza|אֲרִיזָה
lehe'arez|לְהֵיאָרֵז
orez|אוֹרֶז
le'areach|לְאָרֵחַ
lehit'areach|לְהִתְאָרֵחַ
oreach|אוֹרֵחַ
arucha|אֲרוּחָה
orach|אוֹרַח
le'erot|לֶאֱרוֹת
arye|אַרְיֵה
le'eroch|לֶאֱרוֹךְ
leha'arich|לְהַאֲרִיךְ
lehit'arech|לְהִתְאָרֵךְ
orech|אוֹרֶךְ
arka|אַרְכָּה
aroch|אָרוֹךְ
armon|אַרְמוֹן
oren|אוֹרֶן
arnav|אַרְנָב
lehit'ares|לְהִתְאָרֵס
le'area|לְאָרֵעַ
erua|אֵירוּעַ
eretz|אֶרֶץ
leha'arik|לְהַאֲרִיק
le'arer|לְאָרֵר
la'or|לָאוֹר
esh|אֵשׁ
eshech|אֶשֶׁךְ
leha'ashim|לְהַאֲשִׁים
lehe'ashem|לְהֵיאָשֵׁם
ashma|אַשְׁמָה
ashem|אָשֵׁם
le'eshom|לֶאְשׁוֹם
eshnav|אֶשְׁנָב
ashaf|אַשָּׁף
le'ashpez|לְאַשְׁפֵּז
lehit'ashpez|לְהִתְאַשְׁפֵּז
le'asher|לְאַשֵּׁר
ishur|אִישּׁוּר
ashur|אָשׁוּר
asher|אֲשֶׁר
me'ushar|מְאוּשָּׁר
osher|אוֹשֶׁר
lehit'oshesh|לְהִתְאוֹשֵׁשׁ
le'oshesh|לְאוֹשֵׁשׁ
le'ashesh|לְאַשֵּׁשׁ
hit'osheshut|הִתְאוֹשְׁשׁוּת
lehit'oshesh|לְהִתְאוֹשֵׁשׁ
et|אֶת
at|אַתְּ
le'atger|לְאַתְגֵּר
me'utgar|מְאוּתְגָּר
ata|אַתָּה
le'atchel|לְאַתְחֵל
atem|אַתֶּם
etmol|אֶתְמוֹל
aten|אַתֶּן
le'ater|לְאַתֵּר
itur|אִיתּוּר
atar|אֲתָר
etrog|אֶתְרוֹג
atat|אַתָּת
be|בְּ־
be'emtza'ut|בְּאֶמְצָעוּת
mevu'as|מְבוּאָס
leva'es|לְבַאֵס
lehitba'es|לְהִתְבָּאֵס
leva'er|לְבָאֵר
lehitba'er|לְהִתְבָּאֵר
be'er|בְּאֵר
beged|בֶּגֶד
lehibaged|לְהִיבָּגֵד
livgod|לִבְגּוֹד
begin|בְּגִין
biglal|בִּגְלַל
hitbagrut|הִתְבַּגְּרוּת
bagrut|בַּגְרוּת
mevugar|מְבוּגָּר
lehitbager|לְהִתְבַּגֵּר
livgor|לִבְגּוֹר
bad|בַּד
livdo|לִבְדּוֹא
levoded|לְבוֹדֵד
lehitboded|לְהִתְבּוֹדֵד
bad|בַּד
levaded|לְבַדֵּד
levad|לְבַד
bedu'i|בֶּדוּאִי
levadeach|לְבַדֵּחַ
lehitbadeach|לְהִתְבַּדֵּחַ
bdicha|בְּדִיחָה
livdot|לִבְדּוֹת
lehibadot|לְהִיבָּדוֹת
bidyon|בִּדְיוֹן
baduy|בָּדוּי
bidyoni|בִּדְיוֹנִי
levadot|לְבַדּוֹת
lehibadel|לְהִיבָּדֵל
lehavdil|לְהַבְדִּיל
levadel|לְבַדֵּל
hevdel|הֶבְדֵּל
havdala|הַבְדָּלָה
lehitbadel|לְהִתְבַּדֵּל
livdok|לִבְדּוֹק
lehibadek|לְהִיבָּדֵק
mivdak|מִבְדָּק
bdika|בְּדִיקָה
mivdok|מִבְדּוֹק
levader|לְבַדֵּר
lehitbader|לְהִתְבַּדֵּר
bidur|בִּידּוּר
livhot|לִבְהוֹת
lehibahel|לְהִיבָּהֵל
lehavhil|לְהַבְהִיל
mevohal|מְבוֹהָל
tavhela|תַּבְהֵלָה
lehavhil|לְהַבְהִיל
behema|בְּהֵמָה
livhok|לִבְהוֹק
lehavhik|לְהַבְהִיק
lehitbaher|לְהִתְבַּהֵר
lehavhir|לְהַבְהִיר
bahir|בָּהִיר
lavo|לָבוֹא
lehavi|לְהָבִיא
mavo|מָבוֹא
bevaday|בְּווַדַּאי
lavuz|לָבוּז
lehavich|לְהָבִיךְ
mavoch|מָבוֹךְ
mevucha|מְבוּכָה
lehiboch|לְהִיבּוֹךְ
bul|בּוּל
lehitboses|לְהִתְבּוֹסֵס
lehavis|לְהָבִיס
bursa|בּוּרְסָה
levoshesh|לְבוֹשֵׁשׁ
levosh|לֵבוֹשׁ
levazbez|לְבַזְבֵּז
lehitbazbez|לְהִתְבַּזְבֵּז
livzoz|לִבְזוֹז
baz|בַּז
levazot|לְבַזּוֹת
lehitbazot|לְהִתְבַּזּוֹת
bizchut|בִּזְכוּת
livzok|לִבְזוֹק
lehavzik|לְהַבְזִיק
levazer|לְבַזֵּר
livchol|לִבְחוֹל
lehavchil|לְהַבְחִיל
livchon|לִבְחוֹן
lehavchin|לְהַבְחִין
lehibachen|לְהִיבָּחֵן
bochan|בּוֹחַן
mavchena|מַבְחֵנָה
bchina|בְּחִינָה
mivchan|מִבְחָן
avchana|אַבְחָנָה
havchana|הַבְחָנָה
livchor|לִבְחוֹר
lehibacher|לְהִיבָּחֵר
bchira|בְּחִירָה
bachur|בָּחוּר
bachura|בַּחוּרָה
livchosh|לִבְחוֹשׁ
lehitbate|לְהִתְבַּטֵּא
mivta|מִבְטָא
levate|לְבַטֵּא
bita'on|בִּיטָּאוֹן
livtoach|לִבְטוֹחַ
levateach|לְבַטֵּחַ
lehavtiach|לְהַבְטִיחַ
betach|בֶּטַח
avtacha|אַבְטָחָה
bitachon|בִּיטָּחוֹן
bituach|בִּיטּוּחַ
batuach|בָּטוּחַ
lehavtiach|לְהַבְטִיחַ
bituy|בִּיטּוּי
levatel|לְבַטֵּל
lehitbatel|לְהִתְבַּטֵּל
muvtal|מוּבְטָל
avtala|אַבְטָלָה
bitul|בִּיטּוּל
batlan|בַּטְלָן
livtol|לִבְטוֹל
lehitbatel|לְהִתְבַּטֵּל
beten|בֵּטֶן
beyachad|בְּיַחַד
levayel|לְבַייֵּל
levayem|לְבַייֵּם
lehavin|לְהָבִין
hitbonenut|הִתְבּוֹנְנוּת
tovana|תּוֹבָנָה
levonen|לְבוֹנֵן
ben|בֵּין
biyun|בִּיּוּן
levayen|לְבַייֵּן
muvan|מוּבָן
lehitbonen|לְהִתְבּוֹנֵן
benoni|בֵּינוֹנִי
benoni|בֵּינוֹנִי
bentayim|בֵּינְתַייִם
beitza|בֵּיצָה
bira|בִּירָה
lehitbayesh|לְהִתְבַּייֵּשׁ
bayshan|בַּייְשָׁן
levayesh|לְבַייֵּשׁ
bayit|בַּיִת
levayet|לְבַייֵּת
beitkneset|בֵּית כְּנֶסֶת
beitsefer|בֵּית סֵפֶר
livkot|לִבְכּוֹת
levakot|לְבַכּוֹת
bachyan|בַּכְייָן
lehitbachyen|לְהִתְבַּכְייֵן
bchor|בְּכוֹר
lehavkir|לְהַבְכִּיר
bachir|בָּכִיר
bilvad|בִּלְבַד
levalbel|לְבַלְבֵּל
lehitbalbel|לְהִתְבַּלְבֵּל
lehavlig|לְהַבְלִיג
balagan|בָּלָגָן
levalgen|לְבַלְגֵּן
lehavliach|לְהַבְלִיחַ
livlot|לִבְלוֹט
lehavlit|לְהַבְלִיט
lehitbalet|לְהִתְבַּלֵּט
balut|בַּלּוּט
balata|בָּלָטָה
lehitbalot|לְהִתְבַּלּוֹת
livlot|לִבְלוֹת
bli|בְּלִי
levalot|לְבַלּוֹת
biluy|בִּילּוּי
lehitbolel|לְהִתְבּוֹלֵל
livlol|לִבְלוֹל
lehibalem|לְהִיבָּלֵם
blima|בְּלִימָה
balam|בַּלָּם
belem|בֶּלֶם
livlom|לִבְלוֹם
livloa|לִבְלוֹעַ
lehibalea|לְהִיבָּלֵעַ
lebalef|לְבַּלֵף
baleshet|בַּלֶּשֶׁת
balash|בַּלָּשׁ
bilush|בִּילּוּשׁ
livlosh|לִבְלוֹשׁ
bamay|בַּמַּאי
bema'amad|בְּמַעֲמַד
bimkom|בִּמְקוֹם
ben|בֵּן
livnot|לִבְנוֹת
lehibanot|לְהִיבָּנוֹת
banay|בַּנַּאי
binuy|בִּינּוּי
muvne|מוּבְנֶה
tavnit|תַּבְנִית
lehavnot|לְהַבְנוֹת
binyan|בִּנְייָן
levases|לְבַסֵּס
lehitbases|לְהִתְבַּסֵּס
bsisa|בְּסִיסָה
mevusas|מְבוּסָּס
basis|בָּסִיס
leva'abea|לְבַעְבֵּעַ
liv'ot|לִבְעוֹט
lehiba'et|לְהִיבָּעֵט
lehiba'ot|לְהִיבָּעוֹת
be'aya|בְּעָיָה
ba'al|בַּעַל
liv'ol|לִבְעוֹל
be'ikvot|בְּעִקְבוֹת
liv'or|לִבְעוֹר
lehav'ir|לְהַבְעִיר
mav'er|מַבְעֵר
leva'er|לְבַעֵר
ba'at|בַּעַת
lehiba'et|לְהִיבָּעֵת
bifnei|בִּפְנֵי
levatzbetz|לְבַצְבֵּץ
levatzea|לְבַצֵּעַ
lehitbatzea|לְהִתְבַּצֵּעַ
bitzua|בִּיצּוּעַ
mivtza|מִבְצָע
livtzoa|לִבְצוֹעַ
bitza|בִּיצָּה
levatzer|לְבַצֵּר
lehitbatzer|לְהִתְבַּצֵּר
lehibatzer|לְהִיבָּצֵר
livtzor|לִבְצוֹר
baki|בָּקִיא
bakbuk|בַּקְבּוּק
bekalut|בְּקַלּוּת
livkoa|לִבְקוֹעַ
levakea|לְבַקֵּעַ
lehibakea|לְהִיבָּקֵעַ
lehitbakea|לְהִתְבַּקֵּעַ
lehavkia|לְהַבְקִיעַ
levaker|לְבַקֵּר
boker|בּוֹקֶר
bakara|בַּקָּרָה
bikur|בִּיקּוּר
bikoret|בִּיקּוֹרֶת
levakesh|לְבַקֵּשׁ
lehitbakesh|לְהִתְבַּקֵּשׁ
bikush|בִּיקּוּשׁ
bakasha|בַּקָּשָׁה
livro|לִבְרוֹא
lehibare|לְהִיבָּרֵא
lehavri|לְהַבְרִיא
havra'a|הַבְרָאָה
bari|בָּרִיא
levare|לְבָרֵא
bri'ut|בְּרִיאוּת
levarber|לְבַרְבֵּר
lehitbarber|לְהִתְבַּרְבֵּר
lehavrig|לְהַבְרִיג
boreg|בּוֹרֶג
mavreg|מַבְרֵג
lehitbareg|לְהִתְבָּרֵג
lehavriz|לְהַבְרִיז
barzel|בַּרְזֶל
livroach|לִבְרוֹחַ
lehavriach|לְהַבְרִיחַ
brit|בְּרִית
lehitbaryen|לְהִתְבַּרְייֵן
levarech|לְבָרֵךְ
lehitbarech|לְהִתְבָּרֵךְ
bracha|בְּרָכָה
baruch|בָּרוּךְ
berech|בֶּרֶךְ
lehavrik|לְהַבְרִיק
havraka|הַבְרָקָה
barak|בָּרָק
mivrak|מִבְרָק
livrok|לִבְרוֹק
barur|בָּרוּר
levarer|לְבָרֵר
lehitbarer|לְהִתְבָּרֵר
brera|בְּרֵירָה
lavor|לָבוֹר
bareran|בַּרְרָן
muvrar|מוּבְרָר
lehavrish|לְהַבְרִישׁ
bishvil|בִּשְׁבִיל
livshol|לִבְשׁוֹל
levashel|לְבַשֵּׁל
lehavshil|לְהַבְשִׁיל
lehitbashel|לְהִתְבַּשֵּׁל
bishul|בִּישּׁוּל
bashel|בָּשֵׁל
levasem|לְבַשֵּׂם
lehitbasem|לְהִתְבַּשֵּׂם
bosem|בּוֹשֶׂם
beshem|בְּשֵׁם
levaser|לְבַשֵּׂר
basar|בָּשָׂר
bsari|בְּשָׂרִי
lehitbaser|לְהִתְבַּשֵּׂר
bat|בַּת
betoch|בְּתוֹךְ
levatek|לְבַתֵּק
levater|לְבַתֵּר
ga'ava|גַּאֲווָה
lig'ot|לִגְאוֹת
lehitga'ot|לְהִתְגָּאוֹת
ge'e|גֵּאֶה
ga'on|גָּאוֹן
lig'ol|לִגְאוֹל
lehiga'el|לְהִיגָּאֵל
ge'ula|גְּאוּלָּה
legabev|לְגַבֵּב
gav|גַּב
gaba|גַּבָּה
ligboah|לִגְבּוֹהַּ
lehagbiah|לְהַגְבִּיהַּ
govah|גּוֹבַהּ
gavoah|גָּבוֹהַּ
ligbot|לִגְבּוֹת
legabot|לְגַבּוֹת
lehigavot|לְהִיגָּבוֹת
gibuy|גִּיבּוּי
lehagbil|לְהַגְבִּיל
hagbala|הַגְבָּלָה
gvul|גְּבוּל
ligbol|לִגְבּוֹל
gvina|גְּבִינָה
gaban|גַּבָּן
geves|גֶּבֶס
legabes|לְגַבֵּס
giv'a|גִּבְעָה
geva|גֶּבַע
ligbor|לִגְבּוֹר
lehagbir|לְהַגְבִּיר
gibor|גִּיבּוֹר
hitgabrut|הִתְגַּבְּרוּת
gever|גֶּבֶר
gvartan|גְּבַרְתָּן
gvura|גְּבוּרָה
lehitgaber|לְהִתְגַּבֵּר
legabesh|לְגַבֵּשׁ
lehitgabesh|לְהִתְגַּבֵּשׁ
gibush|גִּיבּוּשׁ
legagel|לְגַגֵּל
lehitgoded|לְהִתְגּוֹדֵד
ligdod|לִגְדּוֹד
gdi|גְּדִי
lehagdil|לְהַגְדִּיל
ligdol|לִגְדּוֹל
legadel|לְגַדֵּל
gdila|גְּדִילָה
migdal|מִגְדָּל
hagdala|הַגְדָּלָה
godel|גּוֹדֶל
magdelet|מַגְדֶּלֶת
gadol|גָּדוֹל
agudal|אֲגוּדָל
gidul|גִּידּוּל
ligdom|לִגְדּוֹם
lehigadem|לְהִיגָּדֵם
ligdoa|לִגְדּוֹעַ
legadef|לְגַדֵּף
giduf|גִּידּוּף
legader|לְגַדֵּר
lehagdir|לְהַגְדִּיר
migdar|מִגְדָּר
hagdara|הַגְדָּרָה
gader|גָּדֵר
ligdor|לִגְדּוֹר
lehitgader|לְהִתְגַּדֵּר
lehagdish|לְהַגְדִּישׁ
ligdosh|לִגְדּוֹשׁ
legahetz|לְגַהֵץ
maghetz|מַגְהֵץ
legahek|לְגַהֵק
lighor|לִגְהוֹר
gev|גֵּו
lehagiv|לְהָגִיב
tguva|תְּגוּבָה
mugaz|מוּגָז
lehigoz|לְהִיגּוֹז
legaven|לְגַווֵּן
gaven|גָּווֶן
ligvoa|לִגְווֹעַ
guf|גּוּף
lehagif|לְהָגִיף
gufa|גּוּפָה
lagur|לָגוּר
lehitgorer|לְהִתְגּוֹרֵר
ligzoz|לִגְזוֹז
lehigazez|לְהִיגָּזֵז
ligzol|לִגְזוֹל
lehigazel|לְהִיגָּזֵל
ligzom|לִגְזוֹם
lehigazem|לְהִיגָּזֵם
lehagzim|לְהַגְזִים
giz'i|גִּזְעִי
geza|גֶּזַע
giz'an|גִּזְעָן
giz'anut|גִּזְעָנוּת
lehigazer|לְהִיגָּזֵר
nigzar|נִגְזָר
gazir|גָּזִיר
gizra|גִּזְרָה
gezer|גֶּזֶר
gizaron|גִּיזָּרוֹן
ligzor|לִגְזוֹר
ligchoch|לִגְחוֹךְ
legachech|לְגַחֵךְ
lehagchich|לְהַגְחִיךְ
meguchach|מְגוּחָךְ
ligchon|לִגְחוֹן
ge'ometrya|גֵּיאוֹמֶטְרְיָה
lehagiach|לְהָגִיחַ
lagil|לָגִיל
legayes|לְגַייֵּס
lehitgayes|לְהִתְגַּייֵּס
giyus|גִּיּוּס
legayer|לְגַייֵּר
lehitgayer|לְהִתְגַּייֵּר
giyur|גִּיּוּר
legalgel|לְגַלְגֵּל
lehitgalgel|לְהִתְגַּלְגֵּל
galgal|גַּלְגָּל
gulgolet|גּוּלְגּוֹלֶת
lehaglid|לְהַגְלִיד
glida|גְּלִידָה
legaleach|לְגַלֵּחַ
lehitgaleach|לְהִתְגַּלֵּחַ
giluach|גִּילּוּחַ
legalot|לְגַלּוֹת
lehitgalot|לְהִתְגַּלּוֹת
liglot|לִגְלוֹת
lehigalot|לְהִיגָּלוֹת
lehaglot|לְהַגְלוֹת
gluya|גְּלוּיָה
taglit|תַּגְלִית
galut|גָּלוּת
galuy|גָּלוּי
giluy|גִּילּוּי
legolel|לְגוֹלֵל
lehitgolel|לְהִתְגּוֹלֵל
gal|גַּל
glula|גְּלוּלָה
megila|מְגִילָּה
liglol|לִגְלוֹל
lehigol|לְהִיגּוֹל
legalem|לְגַלֵּם
lehitgalea|לְהִתְגַּלֵּעַ
legalef|לְגַלֵּף
taglif|תַּגְלִיף
glufa|גְּלוּפָה
liglosh|לִגְלוֹשׁ
lehitgalesh|לְהִתְגַּלֵּשׁ
gam|גַּם
ligmo|לִגְמוֹא
gome|גּוֹמֶא
legamgem|לְגַמְגֵּם
legamed|לְגַמֵּד
lehitgamed|לְהִתְגַּמֵּד
lehigamel|לְהִיגָּמֵל
gamal|גָּמָל
gamal|גַּמָּל
tagmul|תַּגְמוּל
ligmol|לִגְמוֹל
ligmor|לִגְמוֹר
lehigamer|לְהִיגָּמֵר
lehagmish|לְהַגְמִישׁ
lignov|לִגְנוֹב
lehiganev|לְהִיגָּנֵב
lehagniv|לְהַגְנִיב
gneva|גְּנֵיבָה
lehitganev|לְהִתְגַּנֵּב
legander|לְגַנְדֵּר
lehitgander|לְהִתְגַּנְדֵּר
lehiganez|לְהִיגָּנֵז
lignoz|לִגְנוֹז
lignoach|לִגְנוֹחַ
leganot|לְגַנּוֹת
legonen|לְגוֹנֵן
lehitgonen|לְהִתְגּוֹנֵן
lehagen|לְהָגֵן
gan|גַּן
ganan|גַּנָּן
lagon|לָגוֹן
magen|מָגֵן
leganen|לְגַנֵּן
ligsos|לִגְסוֹס
gas|גַּס
lega'agea|לְגַעְגֵּעַ
lehitga'agea|לְהִתְגַּעְגֵּעַ
gi'agua|גִּיעְגּוּעַ
ga'agu'im|גַּעְגּוּעִים
lig'ot|לִגְעוֹת
lehag'il|לְהַגְעִיל
lig'ol|לִגְעוֹל
lig'or|לִגְעוֹר
lig'osh|לִגְעוֹשׁ
gefen|גֶּפֶן
legapef|לְגַפֵּף
ligrov|לִגְרוֹב
gerev|גֶּרֶב
legarger|לְגַרְגֵּר
legared|לְגָרֵד
lehitgared|לְהִתְגָּרֵד
garzen|גַּרְזֶן
legarot|לְגָרוֹת
lehitgarot|לְהִתְגָּרוֹת
etgar|אֶתְגָר
lehagril|לְהַגְרִיל
hagrala|הַגְרָלָה
goral|גּוֹרָל
lehigarem|לְהִיגָּרֵם
ligrom|לִגְרוֹם
lehigares|לְהִיגָּרֵס
girsa|גִּירְסָה
ligros|לִגְרוֹס
ligroa|לִגְרוֹעַ
lehigarea|לְהִיגָּרֵעַ
garua|גָּרוּעַ
gera'on|גֵּירָעוֹן
ligrof|לִגְרוֹף
lehigaref|לְהִיגָּרֵף
egrof|אֶגְרוֹף
lehigarer|לְהִיגָּרֵר
legarer|לְגָרֵר
grar|גְּרָר
ligror|לִגְרוֹר
legaresh|לְגָרֵשׁ
lehitgaresh|לְהִתְגָּרֵשׁ
garush|גָּרוּשׁ
geresh|גֶּרֶשׁ
migrash|מִגְרָשׁ
lehagshim|לְהַגְשִׁים
lehitgashem|לְהִתְגַּשֵּׁם
geshem|גֶּשֶׁם
hitgashmut|הִתְגַּשְּׁמוּת
gashum|גָּשׁוּם
legasher|לְגַשֵּׁר
gesher|גֶּשֶׁר
ligshor|לִגְשׁוֹר
legashesh|לְגַשֵּׁשׁ
lehitgoshesh|לְהִתְגּוֹשֵׁשׁ
lid'ov|לִדְאוֹב
lid'og|לִדְאוֹג
lehad'ig|לְהַדְאִיג
de'aga|דְּאָגָה
lid'ot|לִדְאוֹת
da'on|דָּאוֹן
do'ar|דּוֹאַר
ledovev|לְדוֹבֵב
dov|דּוֹב
ledabev|לְדַבֵּב
lidbov|לִדְבּוֹב
ledavlel|לְדַבְלֵל
lidbok|לִדְבּוֹק
lehidavek|לְהִידָּבֵק
madbeka|מַדְבֵּקָה
lehadbik|לְהַדְבִּיק
midabek|מִידַּבֵּק
devek|דֶּבֶק
dibur|דִּיבּוּר
ledaber|לְדַבֵּר
lehadbir|לְהַדְבִּיר
midbar|מִדְבָּר
lehidaver|לְהִידָּבֵר
davar|דָּבָר
lehidaber|לְהִידַּבֵּר
dvir|דְּבִיר
hidavrut|הִידָּבְרוּת
dover|דּוֹבֵר
doveret|דּוֹבֶרֶת
medaber|מְדַבֵּר
dvash|דְּבַשׁ
ledagdeg|לְדַגְדֵּג
lidgol|לִדְגּוֹל
degel|דֶּגֶל
lehadgim|לְהַדְגִּים
degem|דֶּגֶם
dugma|דּוּגְמָה
lidgor|לִדְגּוֹר
lehadgish|לְהַדְגִּישׁ
lidhot|לִדְהוֹת
lehidahem|לְהִידָּהֵם
lehadhim|לְהַדְהִים
lidhor|לִדְהוֹר
duvdevan|דּוּבְדְּבָן
ladug|לָדוּג
dag|דָּג
dod|דּוֹד
dud|דּוּדּ
doda|דּוֹדָה
davka|דַּווְקָא
ledaveach|לְדַווֵּחַ
mediach|מֵדִיחַ
lehadiach|לְהָדִיחַ
hadacha|הֲדָחָה
dave|דָּווֶה
lidvot|לִדְווֹת
duchan|דּוּכָן
ladun|לָדוּן
lehidon|לְהִידּוֹן
davar|דַּווָּר
dor|דּוֹר
dira|דִּירָה
ladur|לָדוּר
ladush|לָדוּשׁ
divush|דִּיוּוּשׁ
davsha|דַּווְשָׁה
ledavesh|לְדַווֵּשׁ
lehidachot|לְהִידָּחוֹת
lidchot|לִדְחוֹת
dachuy|דָּחוּי
dichuy|דִּיחוּי
lidchos|לִדְחוֹס
madches|מַדְחֵס
lidchof|לִדְחוֹף
lehidachef|לְהִידָּחֵף
lidchok|לִדְחוֹק
lehidachek|לְהִידָּחֵק
dachak|דַּחַק
dochak|דּוֹחַק
dchika|דְּחִיקָה
dachuk|דָּחוּק
lehadchik|לְהַדְחִיק
hadchaka|הַדְחָקָה
hedchek|הֶדְחֵק
dayag|דַּייָּג
dyokan|דְּיוֹקָן
day|דַּיי
dayal|דַּייָּל
diyun|דִּיּוּן
dayan|דַּייָּן
din|דִּין
medina|מְדִינָה
lehidayen|לְהִידַּייֵּן
ledayek|לְדַייֵּק
diyuk|דִּיּוּק
meduyak|מְדוּיָּק
ledake|לְדַכֵּא
dika'on|דִּיכָּאוֹן
lidlog|לִדְלוֹג
ledaleg|לְדַלֵּג
meduldal|מְדוּלְדָּל
ledaldel|לְדַלְדֵּל
lehidaldel|לְהִידַּלְדֵּל
lidlot|לִדְלוֹת
ledalot|לְדַלּוֹת
ledalel|לְדַלֵּל
dal|דַּל
dalut|דַּלּוּת
dal|דַּל
dalil|דָּלִיל
lehadlif|לְהַדְלִיף
lidlof|לִדְלוֹף
dlifa|דְּלִיפָה
lehidalek|לְהִידָּלֵק
lehadlik|לְהַדְלִיק
delek|דֶּלֶק
daleket|דַּלֶּקֶת
daluk|דָּלוּק
hadlaka|הַדְלָקָה
lidlok|לִדְלוֹק
delet|דֶּלֶת
ledamdem|לְדַמְדֵּם
demokratya|דֶּמוֹקְרַטְיָה
lidmot|לִדְמוֹת
lehidamot|לְהִידָּמוֹת
ledamot|לְדַמּוֹת
dimyon|דִּמְיוֹן
dmut|דְּמוּת
tadmit|תַּדְמִית
lehadmot|לְהַדְמוֹת
hadmaya|הַדְמָיָה
lehidamot|לְהִידַּמּוֹת
ledamyen|לְדַמְייֵן
lehidom|לְהִידּוֹם
ledamem|לְדַמֵּם
ladom|לָדוֹם
dam|דָּם
lidmoa|לִדְמוֹעַ
dim'a|דִּמְעָה
ledaskes|לְדַסְקֵס
lid'och|לִדְעוֹךְ
ledafdef|לְדַפְדֵּף
dafdefet|דַּפְדֶּפֶת
dafdefan|דַּפְדְּפָן
dofen|דּוֹפֶן
lehadpis|לְהַדְפִּיס
dfus|דְּפוּס
madpeset|מַדְפֶּסֶת
tadpis|תַּדְפִּיס
daf|דַּף
lehidafek|לְהִידָּפֵק
lidpok|לִדְפּוֹק
lehitdapek|לְהִתְדַּפֵּק
ledakdek|לְדַקְדֵּק
dikduk|דִּיקְדּוּק
ledaklem|לְדַקְלֵם
daka|דַּקָּה
dak|דַּק
lidkor|לִדְקוֹר
lehidaker|לְהִידָּקֵר
ledarben|לְדַרְבֵּן
ledareg|לְדָרֵג
madrega|מַדְרֵגָה
hadraga|הַדְרָגָה
darga|דַּרְגָּה
dereg|דֶּרֶג
ledarder|לְדַרְדֵּר
lehidarder|לְהִידַּרְדֵּר
lehidarech|לְהִידָּרֵךְ
lehadrich|לְהַדְרִיךְ
tadrich|תַּדְרִיךְ
derech|דֶּרֶךְ
hadracha|הַדְרָכָה
midracha|מִדְרָכָה
darkon|דַּרְכּוֹן
lidroch|לִדְרוֹךְ
lehidarech|לְהִידָּרֵךְ
lehadrim|לְהַדְרִים
darom|דָּרוֹם
daroma|דָּרוֹמָה
dromi|דְּרוֹמִי
lehidares|לְהִידָּרֵס
dores|דּוֹרֵס
lidros|לִדְרוֹס
lehidaresh|לְהִידָּרֵשׁ
drisha|דְּרִישָׁה
darush|דָּרוּשׁ
midrash|מִדְרָשׁ
midrasha|מִדְרָשָׁה
lidrosh|לִדְרוֹשׁ
deshe|דֶּשֶׁא
ledashdesh|לְדַשְׁדֵּשׁ
doshen|דּוֹשֶׁן
deshen|דֶּשֶׁן
dishun|דִּישּׁוּן
ledashen|לְדַשֵּׁן
dat|דָּת
dati|דָּתִי
lehavhev|לְהַבְהֵב
lehahbil|לְהַהְבִּיל
lahagot|לַהֲגוֹת
lehehagot|לְהֵיהָגוֹת
higayon|הִיגָּיוֹן
lehager|לְהַגֵּר
hagira|הֲגִירָה
lehadhed|לְהַדְהֵד
hadas|הֲדַס
lahadof|לַהֲדוֹף
lehadek|לְהַדֵּק
hedek|הֶדֶק
lehithadek|לְהִתְהַדֵּק
nehedar|נֶהֱדָר
mahadura|מַהֲדוּרָה
hu|הוּא
lehavot|לְהַוּוֹת
lehithavot|לְהִתְהַוּוֹת
hithavut|הִתְהַוּוּת
mehuma|מְהוּמָה
hon|הוֹן
lehaven|לְהַווֵּן
lahazot|לַהֲזוֹת
hazuy|הָזוּי
hi|הִיא
hayom|הַיּוֹם
lihyot|לִהְיוֹת
nihya|נִהְיָה
hechal|הֵיכָל
historya|הִיסְטוֹרְיָה
hacha|הָכָא
halevay|הַלְווַאי
lalechet|לָלֶכֶת
lehalech|לְהַלֵּךְ
lehithalech|לְהִתְהַלֵּךְ
mahalach|מַהֲלָךְ
halich|הֲלִיךְ
halicha|הֲלִיכָה
lehalel|לְהַלֵּל
lehithalel|לְהִתְהַלֵּל
tehilot|תְּהִילּוֹת
tehila|תְּהִילָּה
lehahel|לְהָהֵל
lahalom|לַהֲלוֹם
lahalom|לַהֲלוֹם
hem|הֵם
lehamhem|לְהַמְהֵם
lehamot|לְהַמּוֹת
lahamot|לַהֲמוֹת
lahom|לָהוֹם
lehamem|לְהַמֵּם
mehamem|מְהַמֵּם
lehamer|לְהַמֵּר
himur|הִימּוּר
hen|הֵן
mehandes|מְהַנְדֵּס
handasa|הַנְדָּסָה
lehandes|לְהַנְדֵּס
hine|הִנֵּה
lehanhen|לְהַנְהֵן
lehanot|לֵיהָנוֹת
lehasot|לְהַסּוֹת
lehases|לְהַסֵּס
lehithapech|לְהִתְהַפֵּךְ
lahafoch|לַהֲפוֹךְ
lehehafech|לְהֵיהָפֵךְ
hefech|הֶפֶךְ
hipuch|הִיפּוּךְ
mahpecha|מַהְפֵּכָה
hithapchut|הִתְהַפְּכוּת
lehapnet|לְהַפְּנֵט
laharog|לַהֲרוֹג
lehehareg|לְהֵיהָרֵג
leharher|לְהַרְהֵר
hirhur|הִירְהוּר
laharot|לַהֲרוֹת
herayon|הֵירָיוֹן
hore|הוֹרֶה
lehehares|לְהֵיהָרֵס
laharos|לַהֲרוֹס
heres|הֶרֶס
har|הָר
lehatel|לְהַתֵּל
v|ו־
vada'i|וַדָאִי
levade|לְווַדֵּא
lehitvadot|לְהִתְווַדּוֹת
lehitvadea|לְהִתְווַדֵּעַ
vikuach|וִיכּוּחַ
lehitvakeach|לְהִתְווַכֵּחַ
leholich|לְהוֹלִיךְ
molich|מוֹלִיךְ
levaset|לְווַסֵּת
va'ad|וַעַד
ve'ida|וְעִידָה
lehavrid|לְהַווְרִיד
vered|וֶרֶד
vrid|וְרִיד
varod|וָרוֹד
vetek|וֶתֶק
vatik|וָתִיק
lehotir|לְהוֹתִיר
vitur|וִיתּוּר
levater|לְווַתֵּר
notar|נוֹתָר
ze'ev|זְאֵב
zot|זֹאת
zvuv|זְבוּב
lizboach|לִזְבּוֹחַ
lezabeach|לְזַבֵּחַ
lehizaveach|לְהִיזָּבֵחַ
zevach|זֶבַח
mizbeach|מִזְבֵּחַ
zevel|זֶבֶל
mizbala|מִזְבָּלָה
lezabel|לְזַבֵּל
zagag|זַגָּג
ze|זֶה
lehazhiv|לְהַזְהִיב
zahav|זָהָב
lezahot|לְזַהוֹת
lehizdahot|לְהִזְדַּהוֹת
zihuy|זִיהוּי
zehe|זֵהֶה
zehut|זֶהוּת
lezahem|לְזַהֵם
lehizdahem|לְהִזְדַּהֵם
azhara|אַזְהָרָה
lizhor|לִזְהוֹר
lehazhir|לְהַזְהִיר
lehizaher|לְהִיזָּהֵר
hazhara|הַזְהָרָה
zahir|זָהִיר
zehirut|זְהִירוּת
zo|זוֹ
zu|זוּ
lazuv|לָזוּב
lezaveg|לְזַווֵּג
lehizdaveg|לְהִזְדַּווֵּג
lezaved|לְזַווֵּד
mizvada|מִזְווָדָה
mizvad|מִזְווָד
lazud|לָזוּד
lazuz|לָזוּז
lehaziz|לְהָזִיז
zol|זוֹל
lehazin|לְהָזִין
lehizon|לְהִיזּוֹן
mazon|מָזוֹן
lazun|לָזוּן
lehazia|לְהָזִיעַ
zva'ati|זְווָעָתִי
lazua|לָזוּעַ
zva'a|זְווָעָה
zar|זָר
lehizor|לְהִיזּוֹר
zachiach|זָחִיחַ
lehizdachel|לְהִזְדַּחֵל
lizchol|לִזְחוֹל
lehazid|לְהָזִיד
ziv|זִיו
lehizdayen|לְהִזְדַּייֵּן
zayin|זַיִן
lezayen|לְזַייֵּן
zif|זִיף
lezayef|לְזַייֵּף
zira|זִירָה
zayit|זַיִת
lizkot|לִזְכּוֹת
lezakot|לְזַכּוֹת
zchut|זְכוּת
zikuy|זִיכּוּי
zakay|זַכַּאי
zachyan|זַכְייָן
zach|זַךְ
lizkor|לִזְכּוֹר
lehazkir|לְהַזְכִּיר
lehizacher|לְהִיזָּכֵר
zchira|זְכִירָה
azkara|אַזְכָּרָה
zecher|זֵכֶר
mazkeret|מַזְכֶּרֶת
hazkara|הַזְכָּרָה
azkara|אַזְכָּרָה
tizkoret|תִּזְכּוֹרֶת
zikaron|זִיכָּרוֹן
lizlog|לִזְלוֹג
mazleg|מַזְלֵג
lezalzel|לְזַלְזֵל
zalzal|זַלְזָל
lizlol|לִזְלוֹל
lehazlif|לְהַזְלִיף
zimzum|זִימְזוּם
lezamzem|לְזַמְזֵם
zamzam|זַמְזָם
zima|זִימָּה
lehazim|לְהָזִים
mezima|מְזִימָּה
lizmom|לִזְמוֹם
lezamen|לְזַמֵּן
lehazmin|לְהַזְמִין
zamin|זָמִין
hizdamnut|הִזְדַּמְּנוּת
hazmana|הַזְמָנָה
zman|זְמַן
zmani|זְמַנִּי
zminut|זְמִינוּת
mezuman|מְזוּמָּן
lehizdamen|לְהִזְדַּמֵּן
lezamer|לְזַמֵּר
zamar|זַמָּר
zemer|זֵמֶר
tizmoret|תִּזְמוֹרֶת
mizmor|מִזְמוֹר
lizmor|לִזְמוֹר
zan|זַןּ
znavnav|זְנַבְנַב
zanav|זָנָב
lezanev|לְזַנֵּב
lehizdanev|לְהִזְדַּנֵּב
liznoach|לִזְנוֹחַ
lehazniach|לְהַזְנִיחַ
liznot|לִזְנוֹת
lezanot|לְזַנּוֹת
lezanek|לְזַנֵּק
zinuk|זִינּוּק
lehaznik|לְהַזְנִיק
leza'azea|לְזַעְזֵעַ
lehizda'azea|לְהִזְדַּעְזֵעַ
liz'om|לִזְעוֹם
lehiza'em|לְהִיזָּעֵם
za'am|זַעַם
liz'of|לִזְעוֹף
lehaz'if|לְהַזְעִיף
lehaz'ik|לְהַזְעִיק
liz'ok|לִזְעוֹק
az'aka|אַזְעָקָה
lehizda'ek|לְהִזְדַּעֵק
za'ir|זָעִיר
leza'er|לְזַעֵר
lezapet|לְזַפֵּת
lehizdaken|לְהִזְדַּקֵּן
zaken|זָקֵן
zakan|זָקָן
lehazkin|לְהַזְקִין
lehizakef|לְהִיזָּקֵף
lehizdakef|לְהִזְדַּקֵּף
zikpa|זִקְפָּה
zakuf|זָקוּף
lizkof|לִזְקוֹף
zikuk|זִיקּוּק
lezakek|לְזַקֵּק
lehizakek|לְהִיזָּקֵק
zikuk|זִיקּוּק
zakuk|זָקוּק
lehizdakek|לְהִזְדַּקֵּק
lehazkik|לְהַזְקִיק
lehizdaker|לְהִזְדַּקֵּר
lezargeg|לְזַרְגֵּג
mezurgag|מְזוּרְגָּג
lezarez|לְזָרֵז
lehizdarez|לְהִזְדָּרֵז
zariz|זָרִיז
zaraz|זָרָז
ezrach|אֶזְרָח
lizroach|לִזְרוֹחַ
zricha|זְרִיחָה
mizrach|מִזְרָח
mizracha|מִזְרָחָה
mizrachi|מִזְרָחִי
lizrot|לִזְרוֹת
lehizarot|לְהִיזָּרוֹת
lehazrim|לְהַזְרִים
zerem|זֶרֶם
tazrim|תַּזְרִים
lizrom|לִזְרוֹם
lizroa|לִזְרוֹעַ
lehizarea|לְהִיזָּרֵעַ
zera|זֶרַע
lizrok|לִזְרוֹק
lehizarek|לְהִיזָּרֵק
lehazrik|לְהַזְרִיק
mizraka|מִזְרָקָה
zrika|זְרִיקָה
zer|זֵר
lehechave|לְהֵיחָבֵא
lehitchabe|לְהִתְחַבֵּא
lehachbi|לְהַחְבִּיא
lechabev|לְחַבֵּב
tachbiv|תַּחְבִּיב
lachbov|לַחְבּוֹב
lehitchabev|לְהִתְחַבֵּב
lachbot|לַחְבּוֹט
lehechavet|לְהֵיחָבֵט
machbet|מַחְבֵּט
chaval|חֲבָל
chovel|חוֹבֵל
lechabel|לְחַבֵּל
lehechavel|לְהֵיחָבֵל
tachbula|תַּחְבּוּלָה
chavila|חֲבִילָה
lachbol|לַחְבּוֹל
lechabek|לְחַבֵּק
lachbok|לַחְבּוֹק
lehitchabek|לְהִתְחַבֵּק
lehachbir|לְהַחְבִּיר
lechaber|לְחַבֵּר
lehitchaber|לְהִתְחַבֵּר
chavera|חֲבֵרָה
hitchabrut|הִתְחַבְּרוּת
machberet|מַחְבֶּרֶת
tachbir|תַּחְבִּיר
chavura|חֲבוּרָה
chevra|חֶבְרָה
chaver|חָבֵר
lachavor|לַחֲבוֹר
chibur|חִיבּוּר
tachbura|תַּחְבּוּרָה
lehechavesh|לְהֵיחָבֵשׁ
lachbosh|לַחְבּוֹשׁ
chavita|חֲבִיתָה
machvat|מַחְבָת
lachog|לָחוֹג
chagiga|חֲגִיגָה
chag|חַג
lehechageg|לְהֵיחָגֵג
lachgor|לַחְגּוֹר
chagura|חֲגוּרָה
lechaded|לְחַדֵּד
chad|חַד
chadut|חַדּוּת
mechdal|מֶחְדָּל
lachdol|לַחְדּוֹל
chedek|חֵדֶק
lehachdir|לְהַחְדִּיר
cheder|חֶדֶר
lachdor|לַחְדּוֹר
chadash|חָדָשׁ
lechadesh|לְחַדֵּשׁ
lehitchadesh|לְהִתְחַדֵּשׁ
hitchadshut|הִתְחַדְּשׁוּת
chodesh|חוֹדֶשׁ
chadshan|חַדְשָׁן
chadshani|חַדְשָׁנִי
chodshayim|חוֹדְשַׁייִם
lachuv|לָחוּב
lachug|לָחוּג
mechuga|מְחוּגָה
lachud|לָחוּד
chida|חִידָה
chut|חוּט
lechavet|לְחַווֵּט
chavaya|חֲווָיָה
lehachavot|לְהַחֲווֹת
mechva|מֶחְווָה
machave|מַחֲווֶה
lachavot|לַחֲווֹת
lechavot|לְחַוּוֹת
lachul|לָחוּל
lehitcholel|לְהִתְחוֹלֵל
lehachil|לְהָחִיל
lecholel|לְחוֹלֵל
chum|חוּם
choma|חוֹמָה
chumus|חוּמוּס
lachus|לָחוּס
lehitchaver|לְהִתְחַווֵּר
lehachavir|לְהַחֲווִיר
chiver|חִיווֵּר
lachush|לָחוּשׁ
lehachish|לְהָחִישׁ
tchusha|תְּחוּשָׁה
chaze|חָזֶה
tachazit|תַּחֲזִית
lachazot|לַחֲזוֹת
lehitchazot|לְהִתְחַזּוֹת
chazit|חֲזִית
hitchazut|הִתְחַזּוּת
machaze|מַחֲזֶה
choze|חוֹזֶה
choze|חוֹזֶה
chaziya|חֲזִייָּה
chazir|חֲזִיר
lechazek|לְחַזֵּק
lehitchazek|לְהִתְחַזֵּק
lehachzik|לְהַחְזִיק
lachazok|לַחֲזוֹק
chozek|חוֹזֶק
chazak|חָזָק
chazaka|חֲזָקָה
chezka|חֶזְקָה
lachazor|לַחֲזוֹר
lechazer|לְחַזֵּר
lehachazir|לְהַחֲזִיר
hechzer|הֶחְזֵר
machzor|מַחְזוֹר
lehachati|לְהַחֲטִיא
lachato|לַחֲטוֹא
lechate|לְחַטֵּא
lehitchate|לְהִתְחַטֵּא
lachtov|לַחְטוֹב
lehechatev|לְהֵיחָטֵב
lechatet|לְחַטֵּט
lehechatef|לְהֵיחָטֵף
lehachtif|לְהַחְטִיף
chatuf|חָטוּף
lachtof|לַחְטוֹף
lehitchayev|לְהִתְחַייֵּב
lechayev|לְחַייֵּב
mechuyav|מְחוּיָּב
chova|חוֹבָה
chayav|חַייָּב
chayav|חַייָּב
chov|חוֹב
chiyuv|חִיּוּב
chiyuvi|חִיּוּבִי
hitchayvut|הִתְחַייְּבוּת
mechuyavut|מְחוּיָּבוּת
lechayeg|לְחַייֵּג
chayat|חַייָּט
lechayet|לְחַייֵּט
chiyut|חִיּוּת
lehachayot|לְהַחֲיוֹת
lichyot|לִחְיוֹת
chayim|חַיִּים
michya|מִחְיָה
tchiya|תְּחִייָּה
chaya|חַיָּה
lechayech|לְחַייֵּךְ
chiyuch|חִיּוּךְ
chaychan|חַייְכָן
mechuyach|מְחוּיָּךְ
lecholel|לְחוֹלֵל
lehitcholel|לְהִתְחוֹלֵל
chayal|חַייָּל
tchula|תְּחוּלָה
lechayel|לְחַייֵּל
chek|חֵיק
lechakot|לְחַכּוֹת
lechakech|לְחַכֵּךְ
chikuch|חִיכּוּךְ
lehitchakech|לְהִתְחַכֵּךְ
lehitchakem|לְהִתְחַכֵּם
chochma|חוֹכְמָה
chacham|חָכָם
lachkom|לַחְכּוֹם
lehachkim|לְהַחְכִּים
lehechacher|לְהֵיחָכֵר
lehachkir|לְהַחְכִּיר
lachkor|לַחְכּוֹר
chalav|חָלָב
chalavi|חֲלָבִי
lachlov|לַחְלוֹב
chaluda|חֲלוּדָה
lehachlid|לְהַחְלִיד
chalud|חָלוּד
chulda|חוּלְדָּה
lechalchel|לְחַלְחֵל
lehitchalchel|לְהִתְחַלְחֵל
lehachlit|לְהַחְלִיט
lechalet|לְחַלֵּט
chilut|חִילּוּט
hachlata|הַחְלָטָה
lachlot|לַחְלוֹט
chiltur|חִילְטוּר
lechalter|לְחַלְטֵר
lachalot|לַחֲלוֹת
lechalot|לְחַלּוֹת
machala|מַחֲלָה
lehitchalot|לְהִתְחַלּוֹת
chalon|חַלּוֹן
lechalel|לְחַלֵּל
tchila|תְּחִילָּה
chalal|חָלָל
chalil|חֲלִיל
chalila|חָלִילָה
lehachel|לְהָחֵל
lehachlim|לְהַחְלִים
chalom|חָלוֹם
lachlom|לַחְלוֹם
chalufa|חֲלוּפָה
lehachalif|לְהַחֲלִיף
lehitchalef|לְהִתְחַלֵּף
chalifa|חֲלִיפָה
hachlafa|הַחְלָפָה
lachalof|לַחֲלוֹף
mechlaf|מֶחְלָף
machlef|מַחְלֵף
lachalotz|לַחֲלוֹץ
lehechaletz|לְהֵיחָלֵץ
lechaletz|לְחַלֵּץ
chalutz|חָלוּץ
chultza|חוּלְצָה
lechalek|לְחַלֵּק
lehachalik|לְהַחֲלִיק
chalaklak|חֲלַקְלַק
chelek|חֵלֶק
chalak|חָלָק
chaluka|חֲלוּקָּה
chelkik|חֶלְקִיק
mechalek|מְחַלֵּק
lachalok|לַחֲלוֹק
lehitchalek|לְהִתְחַלֵּק
lehechalek|לְהֵיחָלֵק
lehachalish|לְהַחֲלִישׁ
lachalosh|לַחֲלוֹשׁ
lehitchalesh|לְהִתְחַלֵּשׁ
lehechalesh|לְהֵיחָלֵשׁ
chulsha|חוּלְשָׁה
chalash|חַלָּשׁ
lachalosh|לַחֲלוֹשׁ
cham|חָם
lehachami|לְהַחֲמִיא
chamud|חָמוּד
chemda|חֶמְדָּה
nechmad|נֶחְמָד
lachmod|לַחְמוֹד
chamot|חָמוֹת
lachmol|לַחְמוֹל
chamim|חָמִים
lechamem|לְחַמֵּם
chom|חוֹם
hitchamemut|הִתְחַמְּמוּת
cham|חַם
lehitchamem|לְהִתְחַמֵּם
lehachamitz|לְהַחֲמִיץ
lachmotz|לַחְמוֹץ
chumtza|חוּמְצָה
chometz|חוֹמֶץ
machmatz|מַחְמָץ
chamtzan|חַמְצָן
chamutz|חָמוּץ
lehitchametz|לְהִתְחַמֵּץ
lechamtzen|לְחַמְצֵן
lehitchamtzen|לְהִתְחַמְצֵן
lehitchamek|לְהִתְחַמֵּק
chamakmak|חֲמַקְמַק
lachmok|לַחְמוֹק
lehachmir|לְהַחְמִיר
chemar|חֵימָר
chomer|חוֹמֶר
chamur|חָמוּר
chamor|חֲמוֹר
lehitchamesh|לְהִתְחַמֵּשׁ
chamishi|חֲמִישִׁי
chamush|חָמוּשׁ
chomesh|חוֹמֶשׁ
lachnot|לַחְנוֹט
lehechanet|לְהֵיחָנֵט
lachanot|לַחֲנוֹת
lehachanot|לְהַחֲנוֹת
machane|מַחֲנֶה
chanut|חֲנוּת
tachana|תַּחֲנָה
lechanech|לְחַנֵּךְ
lehechanech|לְהֵיחָנֵךְ
chinuch|חִינּוּךְ
lehitchanech|לְהִתְחַנֵּךְ
chanich|חָנִיךְ
chanuka|חֲנוּכָּה
chinuchi|חִינּוּכִי
lachanoch|לַחֲנוֹךְ
lehitchanen|לְהִתְחַנֵּן
lachon|לָחוֹן
mechunan|מְחוּנָּן
lehitchanef|לְהִתְחַנֵּף
lehachanif|לְהַחֲנִיף
chanfan|חַנְפָן
lachanok|לַחֲנוֹק
lehechanek|לְהֵיחָנֵק
chanika|חֲנִיקָה
lehachnik|לְהַחְנִיק
chenek|חֶנֶק
chanak|חַנָּק
lehitchased|לְהִתְחַסֵּד
chesed|חֶסֶד
chasida|חֲסִידָה
lachasot|לַחֲסוֹת
chasut|חָסוּת
chisayon|חִיסָּיוֹן
lehechasech|לְהֵיחָסֵךְ
lachasoch|לַחֲסוֹךְ
chisachon|חִיסָּכוֹן
lechasel|לְחַסֵּל
lehitchasel|לְהִתְחַסֵּל
chisul|חִיסּוּל
lehechasem|לְהֵיחָסֵם
machsom|מַחְסוֹם
lachsom|לַחְסוֹם
lechasen|לְחַסֵּן
machsan|מַחְסָן
machsanit|מַחְסָנִית
chosen|חוֹסֶן
lehitchasen|לְהִתְחַסֵּן
lehitchasen|לְהִתְחַסֵּן
chasin|חָסִין
chasinut|חֲסִינוּת
lechaspes|לְחַסְפֵּס
mechuspas|מְחוּסְפָּס
lehachsir|לְהַחְסִיר
lachsor|לַחְסוֹר
lechaser|לְחַסֵּר
chaser|חָסֵר
chisaron|חִיסָּרוֹן
choser|חוֹסֶר
chisur|חִיסּוּר
chasarto'elet|חֲסַר תּוֹעֶלֶת
lehechafez|לְהֵיחָפֵז
lechapot|לְחַפּוֹת
lachof|לָחוֹף
lechofef|לְחוֹפֵף
lehitchafef|לְהִתְחָפֵף
lachpof|לַחְפּוֹף
lachpof|לַחְפּוֹף
lachpotz|לַחְפּוֹץ
lachpor|לַחְפּוֹר
lehechafer|לְהֵיחָפֵר
lehitchaper|לְהִתְחַפֵּר
lechapes|לְחַפֵּשׂ
lehitchapes|לְהִתְחַפֵּשׂ
chipus|חִיפּוּשׂ
chofshi|חוֹפְשִׁי
tachposet|תַּחְפּוֹשֶׂת
chofesh|חוֹפֶשׁ
chufsha|חוּפְשָׁה
lachtzov|לַחְצוֹב
lehechatzev|לְהֵיחָצֵב
machtzav|מַחְצָב
chatzav|חָצָב
lachatzot|לַחֲצוֹת
machatzit|מַחֲצִית
chatza'it|חֲצָאִית
lehechatzot|לְהֵיחָצוֹת
chetzi|חֶצִי
yachatz|יַחַץ
lehitchatzef|לְהִתְחַצֵּף
chutzpa|חוּצְפָּה
mechitza|מְחִיצָּה
lechatzetzer|לְחַצְצֵר
chatzer|חָצֵר
lechakot|לְחַקּוֹת
lehitchakot|לְהִתְחַקּוֹת
chakyan|חַקְייָן
chikuy|חִיקּוּי
choken|חוֹקֶן
lechokek|לְחוֹקֵק
tchika|תְּחִיקָּה
chok|חוֹק
lehechakek|לְהֵיחָקֵק
tchika|תְּחִיקָּה
lachkok|לַחְקוֹק
lachkor|לַחְקוֹר
lehechaker|לְהֵיחָקֵר
tachkir|תַּחְקִיר
mechkar|מֶחְקָר
cheker|חֵקֶר
lehecharev|לְהֵיחָרֵב
lacharov|לַחֲרוֹב
lehachariv|לְהַחֲרִיב
churban|חוּרְבָּן
lecharben|לְחַרְבֵּן
lehitcharben|לְהִתְחַרְבֵּן
lacharog|לַחֲרוֹג
lacharod|לַחֲרוֹד
lehechared|לְהֵיחָרֵד
lehachrid|לְהַחְרִיד
machrid|מַחְרִיד
charada|חֲרָדָה
lacharoz|לַחֲרוֹז
lehecharez|לְהֵיחָרֵז
charuz|חָרוּז
chariza|חֲרִיזָה
lehitcharez|לְהִתְחָרֵז
lecharcher|לְחַרְחֵר
lacharot|לַחֲרוֹט
lehecharet|לְהֵיחָרֵט
charata|חֲרָטָה
lehitcharet|לְהִתְחָרֵט
lechartet|לְחַרְטֵט
chartat|חַרְטָט
tacharut|תַּחֲרוּת
lehitcharot|לְהִתְחָרוֹת
mitchare|מִתְחָרֶה
hitcharut|הִתְחָרוּת
lacharot|לַחֲרוֹת
lehachrot|לְהַחְרוֹת
lacharoch|לַחֲרוֹךְ
lehecharech|לְהֵיחָרֵךְ
charach|חָרָךְ
lehacharim|לְהַחֲרִים
cherum|חֵירוּם
lehacharif|לְהַחֲרִיף
lecharef|לְחָרֵף
choref|חוֹרֶף
chorpi|חוֹרְפִּי
charif|חָרִיף
lachrof|לַחְרוֹף
lehitcharfen|לְהִתְחַרְפֵן
lehecharetz|לְהֵיחָרֵץ
charutz|חָרוּץ
lacharotz|לַחֲרוֹץ
lacharok|לַחֲרוֹק
cherek|חֶרֶק
cherut|חֵירוּת
lecharer|לְחָרֵר
lacharosh|לַחֲרוֹשׁ
lehacharish|לְהַחֲרִישׁ
lehecharesh|לְהֵיחָרֵשׁ
cheresh|חֵירֵשׁ
machresha|מַחְרֵשָׁה
lehitcharesh|לְהִתְחָרֵשׁ
lacharot|לַחֲרוֹת
lachshov|לַחְשׁוֹב
lehechashev|לְהֵיחָשֵׁב
lechashev|לְחַשֵּׁב
lehachshiv|לְהַחְשִׁיב
lehitchashev|לְהִתְחַשֵּׁב
hitchashvut|הִתְחַשְּׁבוּת
chishuv|חִישּׁוּב
machshev|מַחְשֵׁב
chashav|חַשָּׁב
cheshbon|חֶשְׁבּוֹן
chashuv|חָשׁוּב
cheshbonit|חֶשְׁבּוֹנִית
lehitchashben|לְהִתְחַשְׁבֵּן
lechashben|לְחַשְׁבֵּן
lachshod|לַחְשׁוֹד
lehechashed|לְהֵיחָשֵׁד
lehachshid|לְהַחְשִׁיד
chashud|חָשׁוּד
chashad|חֲשָׁד
chashay|חֲשַׁאי
lehachashot|לְהַחֲשׁוֹת
lachshoch|לַחְשׁוֹךְ
lehachshich|לְהַחְשִׁיךְ
choshech|חוֹשֶׁךְ
lechashel|לְחַשֵּׁל
lehitchashel|לְהִתְחַשֵּׁל
lechashmel|לְחַשְׁמֵל
lehitchashmel|לְהִתְחַשְׁמֵל
chashmal|חַשְׁמָל
chashmali|חַשְׁמָלִי
lehechasef|לְהֵיחָשֵׂף
chasifa|חֲשִׂיפָה
chasfan|חַשְׂפָן
chasfanit|חַשְׂפָנִית
chasfanut|חַשְׂפָנוּת
lachasof|לַחֲשׂוֹף
lechashek|לְחַשֵּׁק
lehitchashek|לְהִתְחַשֵּׁק
cheshek|חֵשֶׁק
lehechashek|לְהֵיחָשֵׁק
lachshok|לַחְשׁוֹק
lachshosh|לַחְשׁוֹשׁ
chashash|חֲשָׁשׁ
chatul|חָתוּל
chatula|חֲתוּלָה
chatuli|חֲתוּלִי
lachtoch|לַחְתּוֹךְ
lehechatech|לְהֵיחָתֵךְ
chatach|חֲתָךְ
chatich|חָתִיךְ
chaticha|חֲתִיכָה
lechatech|לְחַתֵּךְ
lechatel|לְחַתֵּל
chitul|חִיתּוּל
chataltul|חֲתַלְתּוּל
chataltula|חֲתַלְתּוּלָה
chataltulon|חֲתַלְתּוּלוֹן
chataltulonet|חֲתַלְתּוּלוֹנֶת
chatima|חֲתִימָה
lehechatem|לְהֵיחָתֵם
lehachtim|לְהַחְתִּים
lachtom|לַחְתּוֹם
lechaten|לְחַתֵּן
chatuna|חֲתוּנָּה
chatan|חָתָן
lehitchaten|לְהִתְחַתֵּן
machteret|מַחְתֶּרֶת
lachtor|לַחְתּוֹר
letate|לְטַאְטֵא
mat'ate|מַטְאֲטֵא
tavuach|טָבוּחַ
litboach|לִטְבּוֹחַ
lehitaveach|לְהִיטָּבֵחַ
tabach|טַבָּח
mitbach|מִטְבָּח
tevach|טֶבַח
litbol|לִטְבּוֹל
lehitavel|לְהִיטָּבֵל
lehatbil|לְהַטְבִּיל
litboa|לִטְבּוֹעַ
lehitavea|לְהִיטָּבֵעַ
lehatbia|לְהַטְבִּיעַ
tiv'oni|טִבְעוֹנִי
matbea|מַטְבֵּעַ
teva|טֶבַע
tiv'i|טִבְעִי
tiv'onut|טִבְעוֹנוּת
taba'at|טַבַּעַת
lehatbia|לְהַטְבִּיעַ
letagen|לְטַגֵּן
metugan|מְטוּגָּן
letaher|לְטַהֵר
lithor|לִטְהוֹר
lehitaher|לְהִיטָּהֵר
lehitaher|לְהִיטַּהֵר
tahor|טָהוֹר
tohar|טוֹהַר
latuv|לָטוּב
tova|טוֹבָה
tov|טוֹב
tuzig|טוּזִיג
lehatiach|לְהָטִיחַ
letaveach|לְטַווֵּחַ
tvach|טְווָח
litvot|לִטְווֹת
lehatil|לְהַטִּיל
lehatis|לְהָטִיס
latus|לָטוּס
matos|מָטוֹס
tisa|טִיסָה
matchena|מַטְחֵנָה
litchon|לִטְחוֹן
tachun|טָחוּן
tchina|טְחִינָה
letayev|לְטַייֵּב
tiyul|טִיּוּל
tayelet|טַייֶּלֶת
letayel|לְטַייֵּל
tayas|טַייָּס
letakes|לְטַכֵּס
letalgref|לְטַלְגְּרֵף
letaltel|לְטַלְטֵל
lehitaltel|לְהִיטַּלְטֵל
talit|טַלִּית
tal|טַל
telef|טֶלֶף
letalef|לְטַלֵּף
telefon|טֶלֶפוֹן
letalpen|לְטַלְפֵּן
letame|לְטַמֵּא
lehitame|לְהִיטָּמֵא
letamtem|לְטַמְטֵם
litmon|לִטְמוֹן
lehitamen|לְהִיטָּמֵן
lehatmin|לְהַטְמִין
lehatmia|לְהַטְמִיעַ
lehitamea|לְהִיטָּמֵעַ
letanef|לְטַנֵּף
tinofet|טִינּוֹפֶת
lit'ot|לִטְעוֹת
lehat'ot|לְהַטְעוֹת
ta'ut|טָעוּת
lit'om|לִטְעוֹם
lehat'im|לְהַטְעִים
ta'im|טָעִים
te'ima|טְעִימָה
mat'am|מַטְעָם
ta'am|טַעַם
lehat'in|לְהַטְעִין
lit'on|לִטְעוֹן
mit'an|מִטְעָן
mat'en|מַטְעֵן
lehita'en|לְהִיטָּעֵן
litpoach|לִטְפּוֹחַ
letapeach|לְטַפֵּחַ
tficha|טְפִיחָה
letaftef|לְטַפְטֵף
letapel|לְטַפֵּל
lehitafel|לְהִיטָּפֵל
tipul|טִיפּוּל
litpol|לִטְפּוֹל
letapes|לְטַפֵּס
tofes|טוֹפֶס
litpof|לִטְפּוֹף
metupash|מְטוּפָּשׁ
tipesh|טִיפֵּשׁ
tekes|טֶקֶס
tarud|טָרוּד
lehatrid|לְהַטְרִיד
hatrada|הַטְרָדָה
lehatriach|לְהַטְרִיחַ
litroach|לִטְרוֹחַ
letarter|לְטַרְטֵר
triyut|טְרִיּוּת
tari|טָרִי
litrof|לִטְרוֹף
lehitaref|לְהִיטָּרֵף
lehatrif|לְהַטְרִיף
letarped|לְטַרְפֵּד
lehitarek|לְהִיטָּרֵק
litrok|לִטְרוֹק
tareshet|טָרֶשֶׁת
lehittashtesh|לְהִתְטַשְׁטֵשׁ
letashtesh|לְטַשְׁטֵשׁ
li'ot|לִיאוֹת
leho'il|לְהוֹאִיל
lehiva'esh|לְהִיווָּאֵשׁ
lehitya'esh|לְהִתְייָאֵשׁ
ye'ush|יֵיאוּשׁ
meya'esh|מְייָאֵשׁ
leyabe|לְייַבֵּא
leyabev|לְייַבֵּב
lehovil|לְהוֹבִיל
meyubal|מְיוּבָּל
yabelet|יַבֶּלֶת
movil|מוֹבִיל
lehityabesh|לְהִתְייַבֵּשׁ
livosh|לִיבוֹשׁ
yavesh|יָבֵשׁ
yibush|יִיבּוּשׁ
yabeshet|יַבֶּשֶׁת
yabasha|יַבָּשָׁה
leyabesh|לְייַבֵּשׁ
tuga|תּוּגָה
leyagea|לְייַגֵּעַ
lehityagea|לְהִתְייַגֵּעַ
yagor|יָגוֹר
yad|יָד
yad|יָד
lehityaded|לְהִתְייַדֵּד
yedidut|יְדִידוּת
yadid|יָדִיד
lehodot|לְהוֹדוֹת
lidot|לִידוֹת
toda|תּוֹדָה
leyadot|לְייַדּוֹת
moda'a|מוֹדָעָה
lada'at|לָדַעַת
lehodia|לְהוֹדִיעַ
lehivadea|לְהִיווָּדֵעַ
leyadea|לְייַדֵּעַ
da'at|דַּעַת
yedi'a|יְדִיעָה
yeda|יֶדַע
yad'an|יַדְעָן
hoda'a|הוֹדָעָה
mada|מַדָּע
meda|מֵידָע
mad'an|מַדְעָן
yahadut|יַהֲדוּת
yehudi|יְהוּדִי
yehudiya|יְהוּדִיָּה
yehudi|יְהוּדִי
yahadut|יַהֲדוּת
yom|יוֹם
yoman|יוֹמָן
lehityaven|לְהִתְייַווֵּן
lehozil|לְהוֹזִיל
yazam|יַזָּם
mezam|מֵיזָם
yozma|יוֹזְמָה
lizom|לִיזוֹם
lehazia|לְהַזִּיעַ
lehityached|לְהִתְייַחֵד
meyuchad|מְיוּחָד
yichud|יִיחוּד
yachad|יַחַד
leyached|לְייַחֵד
leyachel|לְייַחֵל
lehityaches|לְהִתְייַחֵס
yachas|יַחַס
leyaches|לְייַחֵס
lehetiv|לְהֵיטִיב
yayin|יַיִן
lehochiach|לְהוֹכִיחַ
lehivacheach|לְהִיווָּכֵחַ
luchal|לוּכַל
yecholet|יְכוֹלֶת
laledet|לָלֶדֶת
leholid|לְהוֹלִיד
lehivaled|לְהִיווָּלֵד
lehityaled|לְהִתְייַלֵּד
yeled|יֶלֶד
yalda|יַלְדָּה
moledet|מוֹלֶדֶת
leda|לֵידָה
yaldut|יַלְדוּת
yeluda|יְלוּדָה
leyaled|לְייַלֵּד
leyalel|לְייַלֵּל
yelala|יְלָלָה
tola'at|תּוֹלַעַת
yama|יַמָּה
yami|יַמִּי
yam|יָם
meyuman|מְיוּמָּן
meyumanut|מְיוּמָּנוּת
lehityamer|לְהִתְייַמֵּר
yomra|יוֹמְרָה
lehonot|לְהוֹנוֹת
leyanen|לְייַנֵּן
lehenik|לְהֵינִיק
linok|לִינוֹק
tinok|תִּינוֹק
tinoket|תִּינוֹקֶת
lisod|לִיסוֹד
lehivased|לְהִיווָּסֵד
yesodiyut|יְסוֹדִיּוּת
yesodi|יְסוֹדִי
yesod|יְסוֹד
mosad|מוֹסָד
yisud|יִיסּוּד
leyased|לְייַסֵּד
yosef|יוֹסֵף
lehosif|לְהוֹסִיף
lehivasef|לְהִיווָּסֵף
tosefet|תּוֹסֶפֶת
lehitosef|לְהִיתּוֹסֵף
hosafa|הוֹסָפָה
yisurim|יִיסּוּרִים
lehityaser|לְהִתְייַסֵּר
leyaser|לְייַסֵּר
lehiva'ed|לְהִיווָּעֵד
mu'ad|מוּעָד
li'od|לִיעוֹד
ya'ad|יַעַד
leya'ed|לְייַעֵד
lehiva'ez|לְהִיווָּעֵז
to'elet|תּוֹעֶלֶת
leho'il|לְהוֹעִיל
leya'el|לְייַעֵל
ya'en|יָעֵן
ya'an|יַעַן
li'of|לִיעוֹף
la'utz|לָעוּץ
lehitya'etz|לְהִתְייַעֵץ
lehiva'etz|לְהִיווָּעֵץ
etza|עֵיצָה
yi'utz|יִיעוּץ
leya'etz|לְייַעֵץ
hitya'atzut|הִתְייַעֲצוּת
lehityapeach|לְהִתְייַפֵּחַ
leyapot|לְייַפּוֹת
yofi|יוֹפִי
yofi|יוֹפִי
lifot|לִיפוֹת
yafe|יָפֶה
mofa|מוֹפָע
lehofia|לְהוֹפִיעַ
tzet|צֵאת
latzet|לָצֵאת
lehotzi|לְהוֹצִיא
leyatze|לְייַצֵּא
totza'a|תּוֹצָאָה
motza|מוֹצָא
yetzi'a|יְצִיאָה
nitzav|נִיצָּב
lehityatzev|לְהִתְייַצֵּב
lehatziv|לְהַצִּיב
matzav|מַצָּב
nitzav|נִיצָּב
yatziv|יַצִּיב
yatzivut|יַצִּיבוּת
leyatzev|לְייַצֵּב
lehatzig|לְהַצִּיג
hatzaga|הַצָּגָה
matzeget|מַצֶּגֶת
leyatzeg|לְייַצֵּג
yitzug|יִיצּוּג
lehatzia|לְהַצִּיעַ
hetzea|הֶיצֵּעַ
hatza'a|הַצָּעָה
latzeket|לָצֶקֶת
mutzak|מוּצָק
lehivatzek|לְהִיווָּצֵק
litzor|לִיצוֹר
lehivatzer|לְהִיווָּצֵר
yitzur|יִיצּוּר
hivatzrut|הִיווָּצְרוּת
yetzer|יֵצֶר
mutzar|מוּצָר
yatzran|יַצְרָן
yetzur|יְצוּר
yetzir|יְצִיר
yatzur|יָצוּר
leyatzer|לְייַצֵּר
lehatzit|לְהַצִּית
matzit|מַצִּית
hatzata|הַצָּתָה
matzat|מַצָּת
yekev|יֶקֶב
moked|מוֹקֵד
likod|לִיקוֹד
lehokia|לְהוֹקִיעַ
lehityaker|לְהִתְייַקֵּר
lehokir|לְהוֹקִיר
yakir|יַקִּיר
yakira|יַקִּירָה
likor|לִיקוֹר
yakar|יָקָר
leyaker|לְייַקֵּר
mokesh|מוֹקֵשׁ
liro|לִירוֹא
lehityare|לְהִתְייָרֵא
nora|נוֹרָא
hora'a|הוֹרָאָה
lehorid|לְהוֹרִיד
yerida|יְרִידָה
laredet|לָרֶדֶת
yareach|יָרֵחַ
leyaret|לְייָרֵט
lirot|לִירוֹט
lirot|לִירוֹת
lehorot|לְהוֹרוֹת
lehiyarot|לְהִייָּרוֹת
yeri|יֶרִי
tora|תּוֹרָה
yarkut|יַרְקוּת
yerek|יֶרֶק
yarak|יָרָק
lirok|לִירוֹק
lehorik|לְהוֹרִיק
yarkan|יַרְקָן
yarkan|יַרְקָן
yarok|יָרוֹק
yerakrak|יְרַקְרַק
lareshet|לָרֶשֶׁת
lehorish|לְהוֹרִישׁ
yerusha|יְרוּשָּׁה
lehivaresh|לְהִיווָּרֵשׁ
yesh|יֵשׁ
toshav|תּוֹשָׁב
lashevet|לָשֶׁבֶת
lehityashev|לְהִתְייַשֵּׁב
leyashev|לְייַשֵּׁב
lehoshiv|לְהוֹשִׁיב
yeshiva|יְשִׁיבָה
yishuv|יִישּׁוּב
yoshev|יוֹשֵׁב
lehoshit|לְהוֹשִׁיט
leyasem|לְייַשֵּׂם
lishon|לִישׁוֹן
shena|שֵׁינָה
yashan|יָשָׁן
lehityashen|לְהִתְייַשֵּׁן
noshan|נוֹשָׁן
lehoshia|לְהוֹשִׁיעַ
lehivashea|לְהִיווָּשֵׁעַ
lehityasher|לְהִתְייַשֵּׁר
yishur|יִישּׁוּר
yashar|יָשָׁר
yashir|יָשִׁיר
leyasher|לְייַשֵּׁר
leheshir|לְהֵישִׁיר
litom|לִיתוֹם
lehityatem|לְהִתְייַתֵּם
yeter|יֶתֶר
yeter|יֶתֶר
metar|מֵיתָר
lehivater|לְהִיווָּתֵר
yitron|יִתְרוֹן
yoter|יוֹתֵר
meyutar|מְיוּתָּר
leyater|לְייַתֵּר
ke|כְּ־
lich'ov|לִכְאוֹב
lehach'iv|לְהַכְאִיב
ke'ev|כְּאֵב
ke'ilu|כְּאִילּוּ
kan|כָּאן
ka'asher|כַּאֲשֶׁר
lehitkabed|לְהִתְכַּבֵּד
lehachbid|לְהַכְבִּיד
lichbod|לִכְבּוֹד
kavod|כָּבוֹד
kaved|כָּבֵד
kvida|כְּבִידָה
kibud|כִּיבּוּד
lechabed|לְכַבֵּד
lechabot|לְכַבּוֹת
lehikavot|לְהִיכָּבוֹת
kabay|כַּבַּאי
kibuy|כִּיבּוּי
lichbot|לִכְבּוֹת
lichbol|לִכְבּוֹל
lehikavel|לְהִיכָּבֵל
lechabes|לְכַבֵּס
michbasa|מִכְבָּסָה
kvisa|כְּבִיסָה
lehachbir|לְהַכְבִּיר
kvar|כְּבָר
keves|כֶּבֶשׂ
lehikavesh|לְהִיכָּבֵשׁ
kvisha|כְּבִישָׁה
kvish|כְּבִישׁ
kivsa|כִּבְשָׂה
lichbosh|לִכְבּוֹשׁ
kegon|כְּגוֹן
keday|כְּדַאי
kadur|כַּדּוּר
kaduregel|כַּדּוּרֶגֶל
kedei|כְּדֵי
lehitkader|לְהִתְכַּדֵּר
lechadrer|לְכַדְרֵר
ko|כֹּה
lichhot|לִכְהוֹת
lehitkahot|לְהִתְכַּהוֹת
kehe|כֵּהֶה
lechahen|לְכַהֵן
kova|כּוֹבַע
koach|כּוֹחַ
lichvot|לִכְווֹת
lehikavot|לְהִיכָּווֹת
kochav|כּוֹכָב
lehachil|לְהָכִיל
mechula|מְכוּלָה
mechal|מֵיכָל
tchula|תְּכוּלָה
lehachin|לְהָכִין
lechaven|לְכַווֵּן
lechonen|לְכוֹנֵן
lehitkaven|לְהִתְכַּווֵּן
lehitkonen|לְהִתְכּוֹנֵן
lehikon|לְהִיכּוֹן
lehachvin|לְהַכְווִין
kavana|כַּווָּנָה
kivun|כִּיוּוּן
machon|מָכוֹן
tchuna|תְּכוּנָה
muchan|מוּכָן
nachon|נָכוֹן
hachana|הֲכָנָה
mechonit|מְכוֹנִית
konenut|כּוֹנְנוּת
konan|כּוֹנָן
konan|כּוֹנָן
mechina|מְכִינָה
kos|כּוֹס
lechavetz|לְכַווֵּץ
lehitkavetz|לְהִתְכַּווֵּץ
hitkavtzut|הִתְכַּווְּצוּת
lechazev|לְכַזֵּב
lehikazev|לְהִיכָּזֵב
lehachziv|לְהַכְזִיב
lehikached|לְהִיכָּחֵד
lehachchid|לְהַכְחִיד
kachol|כָּחוֹל
kchalchal|כְּחַלְחַל
michchol|מִכְחוֹל
lehachchil|לְהַכְחִיל
lehachchish|לְהַכְחִישׁ
lehitkachesh|לְהִתְכַּחֵשׁ
ki|כִּי
kiyor|כִּיּוֹר
kikar|כִּיכָּר
lechayel|לְכַייֵּל
kayas|כַּייָּס
kis|כִּיס
lechayes|לְכַייֵּס
lechayef|לְכַייֵּף
kach|כָּךְ
lechakev|לְכַכֵּב
kikar|כִּכָּר
lichlo|לִכְלוֹא
lehikale|לְהִיכָּלֵא
kele|כֶּלֶא
kelev|כֶּלֶב
klavlav|כְּלַבְלַב
klum|כְּלוּם
lechalot|לְכַלּוֹת
lichlot|לִכְלוֹת
lehitkalot|לְהִתְכַּלּוֹת
kli|כְּלִי
lehitkalkel|לְהִתְכַּלְכֵּל
kalkala|כַּלְכָּלָה
lechalkel|לְכַלְכֵּל
lehikalel|לְהִיכָּלֵל
klal|כְּלָל
michlala|מִכְלָלָה
michlol|מִכְלוֹל
kol|כּוֹל
klali|כְּלָלִי
lehachlil|לְהַכְלִיל
klalut|כְּלָלוּת
lichlol|לִכְלוֹל
lehachlim|לְהַכְלִים
klapei|כְּלַפֵּי
lichmoah|לִכְמוֹהַּ
kama|כַּמָּה
kmo|כְּמוֹ
kamuvan|כַּמּוּבָן
kmot|כְּמוֹת
kim'at|כִּמְעַט
kimut|כִּימּוּת
lekamet|לְכַּמֵּת
ken|כֵּן
lechanot|לְכַנּוֹת
kinuy|כִּינּוּי
lehitkanot|לְהִתְכַּנּוֹת
kina|כִּינָּה
kan|כַּן
lehikanes|לְהִיכָּנֵס
lehachnis|לְהַכְנִיס
lechanes|לְכַנֵּס
lehitkanes|לְהִתְכַּנֵּס
kneset|כְּנֶסֶת
knisa|כְּנִיסָה
hachnasa|הַכְנָסָה
kenes|כֶּנֶס
kinus|כִּינּוּס
michnasayim|מִכְנָסַייִם
lehachnia|לְהַכְנִיעַ
lehikanea|לְהִיכָּנֵעַ
hikan'ut|הִיכָּנְעוּת
kanaf|כָּנָף
kanir'e|כַּנִּרְאֶה
kise|כִּיסֵּא
kes|כֵּס
lechaseach|לְכַסֵּחַ
lechasot|לְכַסּוֹת
lehitkasot|לְהִתְכַּסּוֹת
michsa|מִכְסָה
michse|מִכְסֶה
kisuy|כִּיסּוּי
ksil|כְּסִיל
lichsos|לִכְסוֹס
lehachsif|לְהַכְסִיף
lehikasef|לְהִיכָּסֵף
kaspomat|כַּסְפּוֹמָט
kesef|כֶּסֶף
kasefet|כַּסֶּפֶת
lich'os|לִכְעוֹס
lehach'is|לְהַכְעִיס
ka'as|כַּעַס
lecha'er|לְכַעֵר
lichpot|לִכְפּוֹת
lehikafot|לְהִיכָּפוֹת
kafuy|כָּפוּי
kfiya|כְּפִייָּה
kaful|כָּפוּל
lichpol|לִכְפּוֹל
lehachpil|לְהַכְפִּיל
hachpala|הַכְפָּלָה
kiflayim|כִּפְלַייִם
kefel|כֶּפֶל
lehachfif|לְהַכְפִיף
kafif|כָּפִיף
lechofef|לְכוֹפֵף
kipa|כִּיפָּה
lehitkofef|לְהִתְכּוֹפֵף
kafif|כָּפִיף
kfifa|כְּפִיפָה
kfifa|כְּפִיפָה
lachof|לָכוֹף
kfafa|כְּפָפָה
kaf|כַּף
kaf|כַּף
lichpor|לִכְפּוֹר
lechaper|לְכַפֵּר
kfar|כְּפָר
kapara|כַּפָּרָה
kipur|כִּיפּוּר
lehachpish|לְהַכְפִּישׁ
lichpot|לִכְפּוֹת
lehikafet|לְהִיכָּפֵת
kaftor|כַּפְתּוֹר
lechafter|לְכַפְתֵּר
lehitkarbel|לְהִתְכַּרְבֵּל
kruv|כְּרוּב
kruv|כְּרוּב
lehachriz|לְהַכְרִיז
karoz|כָּרוֹז
kruz|כְּרוּז
muchrach|מוּכְרָח
lehachriach|לְהַכְרִיחַ
korach|כּוֹרַח
hechrechi|הֶכְרֵחִי
hechreach|הֶכְרֵחַ
kartis|כַּרְטִיס
lichrot|לִכְרוֹת
michre|מִכְרֶה
lehikarot|לְהִיכָּרוֹת
kriya|כְּרִייָּה
karish|כָּרִישׁ
karuch|כָּרוּךְ
lichroch|לִכְרוֹךְ
kruchit|כְּרוּכִית
lehikarech|לְהִיכָּרֵךְ
kerech|כֶּרֶךְ
tachrichim|תַּכְרִיכִים
tachrich|תַּכְרִיךְ
karich|כָּרִיךְ
kricha|כְּרִיכָה
karkom|כַּרְכּוֹם
lecharker|לְכַרְכֵּר
lecharsem|לְכַרְסֵם
lehachria|לְהַכְרִיעַ
lichroa|לִכְרוֹעַ
kera|כֶּרַע
lehikaret|לְהִיכָּרֵת
lichrot|לִכְרוֹת
tachshit|תַּכְשִׁיט
lechashkesh|לְכַשְׁכֵּשׁ
lehikashel|לְהִיכָּשֵׁל
lehachshil|לְהַכְשִׁיל
michshol|מִכְשׁוֹל
kishalon|כִּישָּׁלוֹן
keshel|כֶּשֶׁל
lichshol|לִכְשׁוֹל
lechashef|לְכַשֵּׁף
kishuf|כִּישּׁוּף
lehachshir|לְהַכְשִׁיר
kasher|כָּשֵׁר
lichshor|לִכְשׁוֹר
kishron|כִּשְׁרוֹן
tachshir|תַּכְשִׁיר
kashrut|כַּשְׁרוּת
hechsher|הֶכְשֵׁר
lichtov|לִכְתּוֹב
lehikatev|לְהִיכָּתֵב
lehachtiv|לְהַכְתִּיב
lehitkatev|לְהִתְכַּתֵּב
katav|כַּתָּב
hitkatvut|הִתְכַּתְּבוּת
ktiva|כְּתִיבָה
hachtava|הַכְתָּבָה
katava|כַּתָּבָה
michtav|מִכְתָּב
ktav|כְּתָב
tichtovet|תִּכְתּוֹבֶת
ktovet|כְּתוֹבֶת
katvan|כַּתְבָן
tachtiv|תַּכְתִּיב
katuv|כָּתוּב
lechatev|לְכַתֵּב
ktiv|כְּתִיב
kotel|כּוֹתֶל
lehachtim|לְהַכְתִּים
ketem|כֶּתֶם
katom|כָּתוֹם
katef|כָּתֵף
lechater|לְכַתֵּר
lehachtir|לְהַכְתִּיר
lehitkatesh|לְהִתְכַּתֵּשׁ
machtesh|מַכְתֵּשׁ
lichtosh|לִכְתּוֹשׁ
lichtot|לִכְתּוֹת
kita|כִּיתָּה
le|לְ־
lo|לֹא
le'at|לְאַט
lehal'ot|לְהַלְאוֹת
mal'ach|מַלְאָךְ
melacha|מְלָאכָה
lehal'im|לְהַלְאִים
le'an|לְאָן
lev|לֵב
lelabev|לְלַבֵּב
lehitlabet|לְהִתְלַבֵּט
hitlabtut|הִתְלַבְּטוּת
lelabot|לְלַבּוֹת
lelavlev|לְלַבְלֵב
lelaben|לְלַבֵּן
lehalbin|לְהַלְבִּין
malben|מַלְבֵּן
lavan|לָבָן
levana|לְבָנָה
levena|לְבֵנָה
loven|לוֹבֶן
lilbosh|לִלְבּוֹשׁ
lehitlabesh|לְהִתְלַבֵּשׁ
lehalbish|לְהַלְבִּישׁ
halbasha|הַלְבָּשָׁה
tilboshet|תִּלְבּוֹשֶׁת
levush|לְבוּשׁ
lavush|לָבוּשׁ
legabei|לְגַבֵּי
lelagleg|לְלַגְלֵג
lilgom|לִלְגּוֹם
ledivrei|לְדִבְרֵי
lehalhiv|לְהַלְהִיב
lehitlahev|לְהִתְלַהֵב
lehilahev|לְהִילָּהֵב
lilhov|לִלְהוֹב
lehava|לֶהָבָה
lilhot|לִלְהוֹט
lehitlahet|לְהִתְלַהֵט
lahat|לַהַט
lahaka|לַהֲקָה
lahak|לַהַק
lelahek|לְלַהֵק
lehitlahek|לְהִתְלַהֵק
luach|לוּחַ
lehalit|לְהָלִיט
lilvot|לִלְווֹת
lehalvot|לְהַלְווֹת
lehitlavot|לְהִתְלַוּוֹת
lehilavot|לְהִילָּווֹת
livuy|לִיוּוּי
lavyan|לַווְייָן
lelavot|לְלַוּוֹת
lulav|לוּלָב
lehitlonen|לְהִתְלוֹנֵן
malon|מָלוֹן
tluna|תְּלוּנָה
meluna|מְלוּנָה
lehalin|לְהָלִין
lalun|לָלוּן
lalush|לָלוּשׁ
lach|לַח
lechi|לֶחִי
lelachech|לְלַחֵךְ
lilchoch|לִלְחוֹךְ
lilchom|לִלְחוֹם
lehilachem|לְהִילָּחֵם
lehalchim|לְהַלְחִים
lechima|לְחִימָה
lechem|לֶחֶם
malchem|מַלְחֵם
milchama|מִלְחָמָה
lehalchin|לְהַלְחִין
lachan|לַחַן
lehalchitz|לְהַלְחִיץ
lilchotz|לִלְחוֹץ
lehilachetz|לְהִילָּחֵץ
lechitza|לְחִיצָה
lachatz|לַחַץ
lilchosh|לִלְחוֹשׁ
lehitlachesh|לְהִתְלַחֵשׁ
lehitlachshesh|לְהִתְלַחְשֵׁשׁ
lelatef|לְלַטֵּף
liltof|לִלְטוֹף
liltosh|לִלְטוֹשׁ
lelatesh|לְלַטֵּשׁ
leyad|לְיַד
leili|לֵילִי
layla|לַיְלָה
lilach|לִילָךְ
lehitlotzetz|לְהִתְלוֹצֵץ
melitz|מֵלִיץ
lalitz|לָלִיץ
lilkod|לִלְכּוֹד
lelaked|לְלַכֵּד
lehitlaked|לְהִתְלַכֵּד
malkodet|מַלְכּוֹדֶת
lachud|לָכוּד
likud|לִיכּוּד
lehilached|לְהִילָּכֵד
lelachlech|לְלַכְלֵךְ
lehitlachlech|לְהִתְלַכְלֵךְ
meluchlach|מְלוּכְלָךְ
lelachsen|לְלַכְסֵן
lachsin|לַכְסִין
lichsun|לִיכְסוּן
lilmod|לִלְמוֹד
lelamed|לְלַמֵּד
lehilamed|לְהִילָּמֵד
lehitlamed|לְהִתְלַמֵּד
talmud|תַּלְמוּד
talmid|תַּלְמִיד
limud|לִימּוּד
lama|לַמָּה
lema'an|לְמַעַן
lil'og|לִלְעוֹג
lehal'it|לְהַלְעִיט
lela'alea|לְלַעְלֵעַ
lil'os|לִלְעוֹס
lefi|לְפִי
lifnei|לִפְנֵי
lelapef|לְלַפֵּף
lilpot|לִלְפּוֹת
lefita|לְפִיתָה
lehilakeach|לְהִילָּקֵחַ
lehitlakeach|לְהִתְלַקֵּחַ
lakoach|לָקוֹחַ
lakachat|לָקַחַת
lekach|לֶקַח
lekicha|לְקִיחָה
lehilaket|לְהִילָּקֵט
lelaket|לְלַקֵּט
yalkut|יַלְקוּט
lilkot|לִלְקוֹט
lehalkot|לְהַלְקוֹת
lilkot|לִלְקוֹת
lakuy|לָקוּי
likuy|לִיקּוּי
lelakek|לְלַקֵּק
lishka|לִשְׁכָּה
halshana|הַלְשָׁנָה
lashon|לָשׁוֹן
balshan|בַּלְשָׁן
lehalshin|לְהַלְשִׁין
me'od|מְאוֹד
me'az|מֵאָז
me'ayin|מְאַייִן
lema'en|לְמָאֵן
lehima'es|לְהִימָּאֵס
leham'is|לְהַמְאִיס
lim'os|לִמְאוֹס
me'asher|מֵאֲשֶׁר
mabul|מַבּוּל
megama|מְגַמָּה
lemagen|לְמַגֵּן
lemagnet|לְמַגְנֵט
lehitmagnet|לְהִתְמַגְנֵט
lemager|לְמַגֵּר
lamod|לָמוֹד
lehimaded|לְהִימָּדֵד
mida|מִידָּה
medida|מְדִידָה
madad|מַדָּד
lehitmoded|לְהִתְמוֹדֵד
madua|מַדּוּעַ
midur|מִידּוּר
midron|מִדְרוֹן
midroni|מִדְרוֹנִי
ma|מַה
limhol|לִמְהוֹל
lehimahel|לְהִימָּהֵל
lehitmahmeah|לְהִתְמַהְמֵהַּ
lemaher|לְמַהֵר
mahir|מָהִיר
lehimog|לְהִימּוֹג
lehitmogeg|לְהִתְמוֹגֵג
moderni|מוֹדֶרְנִי
muze'on|מוּזֵיאוֹן
muzika|מוּזִיקָה
lemotet|לְמוֹטֵט
lehitmotet|לְהִתְמוֹטֵט
lamut|לָמוּט
lehimot|לְהִימּוֹט
lamul|לָמוּל
lehimol|לְהִימּוֹל
mul|מוּל
muslemi|מוּסְלְמִי
lehamir|לְהָמִיר
tmura|תְּמוּרָה
lamush|לָמוּשׁ
lamut|לָמוּת
lehamit|לְהָמִית
mavet|מָווֶת
limzog|לִמְזוֹג
lehitmazeg|לְהִתְמַזֵּג
mezeg|מֶזֶג
mazgan|מַזְגָן
lemazeg|לְמַזֵּג
lemazeg|לְמַזֵּג
mazal|מַזָּל
lehitmazel|לְהִתְמַזֵּל
lehitmazmez|לְהִתְמַזְמֵז
lemazmez|לְמַזְמֵז
lemaz'er|לְמַזְעֵר
limcho|לִמְחוֹא
mecha'a|מְחָאָה
lehamchiz|לְהַמְחִיז
lemachzer|לְמַחְזֵר
moach|מוֹחַ
limchot|לִמְחוֹט
mimchata|מִמְחָטָה
limchot|לִמְחוֹת
lehimachot|לְהִימָּחוֹת
lehitmachot|לְהִתְמַחוֹת
lemachot|לְמַחוֹת
mumche|מוּמְחֶה
limchol|לִמְחוֹל
mechila|מְחִילָה
limchotz|לִמְחוֹץ
lehimachetz|לְהִימָּחֵץ
limchok|לִמְחוֹק
lehimachek|לְהִימָּחֵק
mechika|מְחִיקָה
machik|מָחִיק
machar|מָחָר
mechir|מְחִיר
mochoratayim|מָחֳרָתַייִם
lehamchish|לְהַמְחִישׁ
lemachshev|לְמַחְשֵׁב
lehamtir|לְהַמְטִיר
mamtera|מַמְטֵרָה
matar|מָטָר
mitriya|מִטְרִייָּה
mi|מִי
mayim|מַיִם
meiman|מֵימָן
miyun|מִיּוּן
min|מִין
tmuna|תְּמוּנָה
min|מִין
lemayen|לְמַייֵּן
mishehu|מִישֶׁהוּ
mishehi|מִישֶׁהִי
limkor|לִמְכּוֹר
lehitmaker|לְהִתְמַכֵּר
lehimacher|לְהִימָּכֵר
mechira|מְכִירָה
machur|מָכוּר
hitmakrut|הִתְמַכְּרוּת
lehitmale|לְהִתְמַלֵּא
limlot|לִמְלֹאת
male|מָלֵא
lemale|לְמַלֵּא
melacha|מְלָאכָה
milga|מִלְגָּה
melach|מֶלַח
maluach|מָלוּחַ
lehamliach|לְהַמְלִיחַ
lemalet|לְמַלֵּט
lehimalet|לְהִימָּלֵט
lehamlit|לְהַמְלִיט
milut|מִילּוּט
melita|מְלִיטָה
melet|מֶלֶט
melech|מֶלֶךְ
mamlacha|מַמְלָכָה
lehamlich|לְהַמְלִיךְ
mamlachti|מַמְלַכְתִּי
malka|מַלְכָּה
malchut|מַלְכוּת
mamlachtiyut|מַמְלַכְתִּיּוּת
limloch|לִמְלוֹךְ
lemalked|לְמַלְכֵּד
lemalel|לְמַלֵּל
melel|מֶלֶל
mila|מִילָּה
milon|מִילּוֹן
lemalmel|לְמַלְמֵל
melafefon|מְלָפְפוֹן
lehamlitz|לְהַמְלִיץ
hamlatza|הַמְלָצָה
meltzar|מֶלְצַר
limlok|לִמְלוֹק
lemamen|לְמַמֵּן
mimun|מִימּוּן
lemamesh|לְמַמֵּשׁ
lehitmamesh|לְהִתְמַמֵּשׁ
mimush|מִימּוּשׁ
mamash|מַמָּשׁ
mamash|מַמָּשׁ
min|מִן
mangina|מַנְגִּינָה
mincha|מִנְחָה
limnot|לִמְנוֹת
lehimanot|לְהִימָּנוֹת
lemanot|לְמַנּוֹת
menaya|מְנָיָה
manuy|מָנוּי
minuy|מִינּוּי
mana|מָנָה
lehitmanot|לְהִתְמַנּוֹת
lemanen|לְמַנֵּן
limnoa|לִמְנוֹעַ
lehimanea|לְהִימָּנֵעַ
meni'a|מְנִיעָה
lemanef|לְמַנֵּף
lemasger|לְמַסְגֵּר
lemased|לְמַסֵּד
mimsad|מִמְסָד
lehitmased|לְהִתְמַסֵּד
mischur|מִיסְחוּר
lehitmascher|לְהִתְמַסְחֵר
lemascher|לְמַסְחֵר
lehitmastel|לְהִתְמַסְטֵל
lemasot|לְמַסּוֹת
misken|מִסְכֵּן
lemasmer|לְמַסְמֵר
lehitmoses|לְהִתְמוֹסֵס
mas|מַס
lehamis|לְהָמִיס
tmisa|תְּמִיסָּה
lehimos|לְהִימּוֹס
lemasper|לְמַסְפֵּר
limsor|לִמְסוֹר
lehimaser|לְהִימָּסֵר
lehitmaser|לְהִתְמַסֵּר
meser|מֶסֶר
lemasrer|לְמַסְרֵר
lim'od|לִמְעוֹד
leham'id|לְהַמְעִיד
lema'et|לְמַעֵט
leham'it|לְהַמְעִיט
lehitma'et|לְהִתְמַעֵט
ma'at|מָעַט
me'at|מְעַט
mu'at|מוּעָט
lim'och|לִמְעוֹךְ
lehima'ech|לְהִימָּעֵךְ
me'il|מְעִיל
lim'ol|לִמְעוֹל
me'al|מֵעַל
lema'en|לְמַעֵן
ma'an|מַעַן
lim'on|לִמְעוֹן
me'ata|מֵעַתָּה
lemapot|לְמַפּוֹת
mipnei|מִפְּנֵי
mofet|מוֹפֵת
limtzo|לִמְצוֹא
lehimatze|לְהִימָּצֵא
lehamtzi|לְהַמְצִיא
hitmatz'ut|הִתְמַצְּאוּת
himatz'ut|הִימָּצְאוּת
hamtza'a|הַמְצָאָה
metzi'ut|מְצִיאוּת
lehitmatze|לְהִתְמַצֵּא
metzi'a|מְצִיאָה
mitzuv|מִיצּוּב
lematzev|לְמַצֵּב
metzach|מֵצַח
lematzot|לְמַצּוֹת
limtzot|לִמְצוֹת
matzuy|מָצוּי
tamtzit|תַּמְצִית
lematzmetz|לְמַצְמֵץ
emtza'ut|אֶמְצָעוּת
emtza|אֶמְצַע
limtzotz|לִמְצוֹץ
lehimatzetz|לְהִימָּצֵץ
lehitmatzek|לְהִתְמַצֵּק
mitzrayim|מִצְרַייִם
lemaked|לְמַקֵּד
lehitmaked|לְהִתְמַקֵּד
lehitmakeach|לְהִתְמַקֵּחַ
miktoren|מִקְטוֹרֶן
lemakem|לְמַקֵּם
lehitmakem|לְהִתְמַקֵּם
lemakef|לְמַקֵּף
lehitmaktzea|לְהִתְמַקְצֵעַ
lehimek|לְהִימֵּק
lemakesh|לְמַקֵּשׁ
mar|מַר
lehamri|לְהַמְרִיא
hamra'a|הַמְרָאָה
limrod|לִמְרוֹד
lehitmared|לְהִתְמָרֵד
mered|מֶרֶד
mardan|מַרְדָן
limroach|לִמְרוֹחַ
lehimareach|לְהִימָּרֵחַ
limrot|לִמְרוֹט
lehamrot|לְהַמְרוֹת
lemarkez|לְמַרְכֵּז
lemarmer|לְמַרְמֵר
lehitmarmer|לְהִתְמַרְמֵר
lemarpek|לְמַרְפֵּק
lehamritz|לְהַמְרִיץ
hamratza|הַמְרָצָה
meretz|מֶרֶץ
tamritz|תַּמְרִיץ
tamruk|תַּמְרוּק
marak|מָרָק
lemarek|לְמָרֵק
marir|מָרִיר
lehamer|לְהָמֵר
lemarer|לְמָרֵר
mar|מַר
masa|מַשָּׂא
masa'it|מַשָּׂאִית
lehamsig|לְהַמְשִׂיג
mashehu|מַשֶּׁהוּ
limshoach|לִמְשׁוֹחַ
mishcha|מִשְׁחָה
limshot|לִמְשׁוֹת
lehimashot|לְהִימָּשׁוֹת
meshicha|מְשִׁיכָה
limshoch|לִמְשׁוֹךְ
lehimashech|לְהִימָּשֵׁךְ
lehitmashech|לְהִתְמַשֵּׁךְ
lehamshich|לְהַמְשִׁיךְ
hemshech|הֶמְשֵׁךְ
meshech|מֶשֶׁךְ
lemashken|לְמַשְׁכֵּן
limshol|לִמְשׁוֹל
lehamshil|לְהַמְשִׁיל
lehimashel|לְהִימָּשֵׁל
mashal|מָשָׁל
memshelet|מֶמְשֶׁלֶת
memshalti|מֶמְשַׁלְתִּי
lemashmea|לְמַשְׁמֵעַ
lemashmesh|לְמַשְׁמֵשׁ
meshek|מֶשֶׁק
mishkefeishemesh|מִשְׁקְפֵי שֵׁמֶשׁ
lemashesh|לְמַשֵּׁשׁ
lemateg|לְמַתֵּג
meteg|מֶתֶג
limtoach|לִמְתּוֹחַ
lehimateach|לְהִימָּתֵחַ
metichut|מְתִיכוּת
metach|מֶתַח
metach|מֶתַח
matuach|מָתוּחַ
matiach|מָתִיחַ
lehitmateach|לְהִתְמַתֵּחַ
mitachat|מִתַּחַת
matay|מָתַי
matematika|מָתֶמָטִיקָה
lematen|לְמַתֵּן
lehamtin|לְהַמְתִּין
lehamtik|לְהַמְתִּיק
mamtak|מַמְתָּק
matok|מָתוֹק
na|נָא
lin'ot|לִנְאוֹת
lin'om|לִנְאוֹם
ne'um|נְאוּם
lena'ef|לְנָאֵף
lin'of|לִנְאוֹף
lena'etz|לְנָאֵץ
lin'ok|לִנְאוֹק
ne'aka|נְאָקָה
lenabe|לְנַבֵּא
lehitnabe|לְהִתְנַבֵּא
lehinave|לְהִינָּבֵא
nevu'a|נְבוּאָה
navi|נָבִיא
linboach|לִנְבּוֹחַ
navchan|נַבְחָן
lehanbit|לְהַנְבִּיט
lehabit|לְהַבִּיט
mabat|מַבָּט
linbot|לִנְבּוֹט
linbol|לִנְבּוֹל
naval|נָבָל
linboa|לִנְבּוֹעַ
lehabia|לְהַבִּיעַ
haba'a|הַבָּעָה
linbor|לִנְבּוֹר
lenagev|לְנַגֵּב
lehitnagev|לְהִתְנַגֵּב
magevet|מַגֶּבֶת
magev|מַגֵּב
magvon|מַגְּבוֹן
lehangid|לְהַנְגִּיד
nagad|נַגָּד
lehitnaged|לְהִתְנַגֵּד
hitnagdut|הִתְנַגְּדוּת
menugad|מְנוּגָּד
agada|אַגָּדָה
neged|נֶגֶד
hagada|הַגָּדָה
lehagid|לְהַגִּיד
lingod|לִנְגּוֹד
lingoah|לִנְגּוֹהַּ
lehagiah|לְהַגִּיהַּ
nogah|נוֹגַהּ
lingoach|לִנְגּוֹחַ
nagach|נַגָּח
lenagen|לְנַגֵּן
nigun|נִיגּוּן
lehitnagen|לְהִתְנַגֵּן
lingos|לִנְגּוֹס
maga|מַגָּע
lehagia|לְהַגִּיעַ
laga'at|לָגַעַת
lenagea|לְנַגֵּעַ
nega|נֶגַע
lehinagef|לְהִינָּגֵף
lehinager|לְהִינָּגֵר
nagar|נַגָּר
lenager|לְנַגֵּר
lageshet|לָגֶשֶׁת
lehagish|לְהַגִּישׁ
lehangish|לְהַנְגִּישׁ
hitnagshut|הִתְנַגְּשׁוּת
nagish|נָגִישׁ
lehitnagesh|לְהִתְנַגֵּשׁ
lenadev|לְנַדֵּב
lehitnadev|לְהִתְנַדֵּב
nedava|נְדָבָה
hitnadvut|הִתְנַדְּבוּת
nadiv|נָדִיב
nedivut|נְדִיבוּת
lindov|לִנְדּוֹב
lindod|לִנְדּוֹד
hadacha|הַדָּחָה
lehadiach|לְהַדִּיחַ
lenadot|לְנַדּוֹת
lenadned|לְנַדְנֵד
lehitnadned|לְהִתְנַדְנֵד
lehitnadef|לְהִתְנַדֵּף
madaf|מַדָּף
lidor|לִידּוֹר
neder|נֶדֶר
nadir|נָדִיר
lehadir|לְהַדִּיר
lehitnaheg|לְהִתְנַהֵג
linhog|לִנְהוֹג
lehanhig|לְהַנְהִיג
nehag|נֶהָג
hitnahagut|הִתְנַהֲגוּת
nehiga|נְהִיגָה
minhag|מִנְהָג
lenahel|לְנַהֵל
minhal|מִנְהָל
menahel|מְנַהֵל
nohal|נוֹהַל
lehitnahel|לְהִתְנַהֵל
linhom|לִנְהוֹם
linhok|לִנְהוֹק
linhor|לִנְהוֹר
nahar|נָהָר
minhara|מִנְהָרָה
lehani|לְהָנִיא
lehaniv|לְהָנִיב
lanuv|לָנוּב
lanud|לָנוּד
lehitnoded|לְהִתְנוֹדֵד
lehanid|לְהָנִיד
tnuda|תְּנוּדָה
lanuach|לָנוּחַ
lehaniach|לְהָנִיחַ
lehaniach|לְהַנִּיחַ
tnucha|תְּנוּחָה
menucha|מְנוּחָה
nachat|נַחַת
noach|נוֹחַ
nochut|נוֹחוּת
lenavet|לְנַווֵּט
navat|נַווָּט
nave|נָאווֶה
linvot|לִנְווֹת
lanum|לָנוּם
lehitnaven|לְהִתְנַווֵּן
lenaven|לְנַווֵּן
menuvan|מְנוּוָּן
lehanis|לְהָנִיס
lanus|לָנוּס
manos|מָנוֹס
lanua|לָנוּעַ
lehania|לְהָנִיעַ
lehitno'ea|לְהִתְנוֹעֵעַ
tnu'a|תְּנוּעָה
manoa|מָנוֹעַ
lenofef|לְנוֹפֵף
lehitnofef|לְהִתְנוֹפֵף
lehanif|לְהָנִיף
manof|מָנוֹף
menifa|מְנִיפָה
nof|נוֹף
tanur|תַּנּוּר
nur|נוּר
menora|מְנוֹרָה
ner|נֵר
nura|נוּרָה
lehazot|לְהַזּוֹת
lehanzil|לְהַנְזִיל
linzol|לִנְזוֹל
lehazil|לְהַזִּיל
nazelet|נַזֶּלֶת
lehinazef|לְהִינָּזֵף
linzof|לִנְזוֹף
lehazik|לְהַזִּיק
lehinazek|לְהִינָּזֵק
lehitnazer|לְהִתְנַזֵּר
lehanchot|לְהַנְחוֹת
hanchaya|הַנְחָיָה
linchol|לִנְחוֹל
lehanchil|לְהַנְחִיל
lehitnachel|לְהִתְנַחֵל
nachala|נַחֲלָה
lenachem|לְנַחֵם
lehinachem|לְהִינָּחֵם
nechama|נֶחָמָה
lehitnachem|לְהִתְנַחֵם
lehitnachmed|לְהִתְנַחְמֵד
nachutz|נָחוּץ
linchor|לִנְחוֹר
nechir|נְחִיר
lenachesh|לְנַחֵשׁ
nachash|נָחָשׁ
nechoshet|נְחוֹשֶׁת
linchot|לִנְחוֹת
nechat|נֶחָת
lehanchit|לְהַנְחִית
lintot|לִנְטוֹת
lehatot|לְהַטּוֹת
lehinatot|לְהִינָּטוֹת
lemata|לְמַטָּה
mita|מִיטָּה
matala|מַטָּלָה
litol|לִיטּוֹל
lehinatea|לְהִינָּטֵעַ
lata'at|לָטַעַת
lintof|לִנְטוֹף
lehatif|לְהַטִּיף
lintor|לִנְטוֹר
matara|מַטָּרָה
lenater|לְנַטֵּר
nitur|נִיטּוּר
lenatrel|לְנַטְרֵל
lintosh|לִנְטוֹשׁ
lehinatesh|לְהִינָּטֵשׁ
lehinatesh|לְהִינָּטֵשׁ
natush|נָטוּשׁ
nayad|נַייָּד
nayad|נַייָּד
nayedet|נַייֶּדֶת
lehitnayed|לְהִתְנַייֵּד
nichoach|נִיחוֹחַ
neyar|נְייָר
nin|נִין
nina|נִינָה
neched|נֶכֶד
nechda|נֶכְדָּה
linkoach|לִנְכּוֹחַ
lehanchiach|לְהַנְכִיחַ
nocheach|נוֹכֵחַ
lehakot|לְהַכּוֹת
lenakot|לְנַכּוֹת
nache|נָכֶה
nachut|נָכוּת
maka|מַכָּה
nikuy|נִיכּוּי
lehitnakel|לְהִתְנַכֵּל
nochel|נוֹכֵל
hakara|הַכָּרָה
lehinacher|לְהִינָּכֵר
lenaker|לְנַכֵּר
nar|נַר
lehakir|לְהַכִּיר
lehitnaker|לְהִתְנַכֵּר
lehakish|לְהַכִּישׁ
makosh|מַכּוֹשׁ
lehalin|לְהַלִּין
lehanmich|לְהַנְמִיךְ
hanmacha|הַנְמָכָה
namuch|נָמוּךְ
namel|נָמֵל
lenamnem|לְנַמְנֵם
lehitnamnem|לְהִתְנַמְנֵם
menumas|מְנוּמָּס
lenamek|לְנַמֵּק
nimuk|נִימּוּק
namer|נָמֵר
nesiga|נְסִיגָה
lehasig|לְהַסִּיג
lehasiach|לְהַסִּיחַ
nuscha|נוּסְחָה
lenaseach|לְנַסֵּחַ
lenasot|לְנַסּוֹת
nisayon|נִיסָּיוֹן
nisuy|נִיסּוּי
lehitnasot|לְהִתְנַסּוֹת
nesicha|נְסִיכָה
nasich|נָסִיךְ
linsoch|לִנְסוֹךְ
masecha|מַסֵּכָה
nes|נֵס
lehitnoses|לְהִתְנוֹסֵס
nesi'a|נְסִיעָה
masa|מַסָּע
masoa|מַסּוֹעַ
linsoa|לִנְסוֹעַ
lehasia|לְהַסִּיעַ
lehasik|לְהַסִּיק
lehasik|לְהַסִּיק
linsok|לִנְסוֹק
masok|מַסּוֹק
maskana|מַסְּקָנָה
lenaser|לְנַסֵּר
nesoret|נְסוֹרֶת
masor|מַסּוֹר
linsor|לִנְסוֹר
lin'ol|לִנְעוֹל
lin'ol|לִנְעוֹל
tin'olet|תִּנְעוֹלֶת
lehan'il|לְהַנְעִיל
na'al|נַעַל
ne'ila|נְעִילָה
lehina'el|לְהִינָּעֵל
man'ul|מַנְעוּל
lin'om|לִנְעוֹם
lehan'im|לְהַנְעִים
na'im|נָעִים
ne'ima|נְעִימָה
lena'anea|לְנַעְנֵעַ
lin'otz|לִנְעוֹץ
na'utz|נָעוּץ
ne'urim|נְעוּרִים
lena'er|לְנַעֵר
lehitna'er|לְהִתְנַעֵר
lehina'er|לְהִינָּעֵר
lin'or|לִנְעוֹר
na'ar|נַעַר
na'ara|נַעֲרָה
linpoach|לִנְפּוֹחַ
lenapeach|לְנַפֵּחַ
lehitnapeach|לְהִתְנַפֵּחַ
napach|נַפָּח
tapuach|תַּפּוּחַ
lenapot|לְנַפּוֹת
lehapil|לְהַפִּיל
lipol|לִיפּוֹל
hapala|הַפָּלָה
lehitnapel|לְהִתְנַפֵּל
lenafnef|לְנַפְנֵף
lenapetz|לְנַפֵּץ
lehitnapetz|לְהִתְנַפֵּץ
niputz|נִיפּוּץ
napatz|נַפָּץ
lehanpik|לְהַנְפִּיק
lehapik|לְהַפִּיק
lehanpish|לְהַנְפִּישׁ
nefesh|נֶפֶשׁ
linposh|לִנְפּוֹשׁ
netziv|נְצִיב
natzig|נָצִיג
netzigut|נְצִיגוּת
lenatzeach|לְנַצֵּחַ
lehitnatzeach|לְהִתְנַצֵּחַ
lehantziach|לְהַנְצִיחַ
hantzacha|הַנְצָחָה
nitzuach|נִיצּוּחַ
nitzachon|נִיצָּחוֹן
menatzeach|מְנַצֵּחַ
hatzala|הַצָּלָה
lehatzil|לְהַצִּיל
lehinatzel|לְהִינָּצֵל
lenatzel|לְנַצֵּל
lehitnatzel|לְהִתְנַצֵּל
nitzul|נִיצּוּל
natzlan|נַצְלָן
nitzolet|נִיצּוֹלֶת
lenatznetz|לְנַצְנֵץ
lehitnotzetz|לְהִתְנוֹצֵץ
lehanetz|לְהָנֵץ
lintzotz|לִנְצוֹץ
lehanetz|לְהָנֵץ
nitzan|נִיצָּן
nitzotz|נִיצוֹץ
lehitnatzer|לְהִתְנַצֵּר
hitnatzrut|הִתְנַצְּרוּת
notzri|נוֹצְרִי
natzrut|נַצְרוּת
lintzor|לִנְצוֹר
linkov|לִנְקוֹב
nekeva|נְקֵבָה
nikud|נִיקּוּד
nekuda|נְקוּדָּה
lenaked|לְנַקֵּד
lehitnakez|לְהִתְנַקֵּז
lenakez|לְנַקֵּז
lehinaket|לְהִינָּקֵט
linkot|לִנְקוֹט
lenakot|לְנַקּוֹת
nikuy|נִיקּוּי
nikayon|נִיקָּיוֹן
lehitnakot|לְהִתְנַקּוֹת
naki|נָקִי
makel|מַקֵּל
linkom|לִנְקוֹם
nekama|נְקָמָה
lehitnakem|לְהִתְנַקֵּם
linkoa|לִנְקוֹעַ
lehakif|לְהַקִּיף
makaf|מַקָּף
linkof|לִנְקוֹף
makor|מַקּוֹר
lenaker|לְנַקֵּר
nakar|נַקָּר
linkosh|לִנְקוֹשׁ
lehitnakesh|לְהִתְנַקֵּשׁ
lehakish|לְהַקִּישׁ
makash|מַקָּשׁ
nasuy|נָשׂוּי
lehitnase|לְהִתְנַשֵּׂא
laset|לָשֵׂאת
lehinase|לְהִינָּשֵׂא
lehasi|לְהַשִּׂיא
nasi|נָשִׂיא
si|שִׂיא
tsu'a|תְּשׂוּאָה
musa|מוּשָּׂא
nose|נוֹשֵׂא
lenashev|לְנַשֵּׁב
linshov|לִנְשׁוֹב
lehasig|לְהַשִּׂיג
musag|מוּשָּׂג
heseg|הֶישֵּׂג
lenashech|לְנַשֵּׁךְ
linshoch|לִנְשׁוֹךְ
lehinashech|לְהִינָּשֵׁךְ
lenashel|לְנַשֵּׁל
linshol|לִנְשׁוֹל
lehashil|לְהַשִּׁיל
linshom|לִנְשׁוֹם
lehitnashem|לְהִתְנַשֵּׁם
neshama|נְשָׁמָה
lehanshim|לְהַנְשִׁים
hanshama|הַנְשָׁמָה
lenashnesh|לְנַשְׁנֵשׁ
linshof|לִנְשׁוֹף
lehitnashef|לְהִתְנַשֵּׁף
neshef|נֶשֶׁף
lenashef|לְנַשֵּׁף
yanshuf|יַנְשׁוּף
lenashek|לְנַשֵּׁק
lehashik|לְהַשִּׁיק
lehitnashek|לְהִתְנַשֵּׁק
mashik|מַשִּׁיק
neshika|נְשִׁיקָה
neshek|נֵשֶׁק
linshok|לִנְשׁוֹק
linshor|לִנְשׁוֹר
lehanshir|לְהַנְשִׁיר
nesher|נֶשֶׁר
lehashir|לְהַשִּׁיר
lenatev|לְנַתֵּב
nativ|נָתִיב
lehatiz|לְהַתִּיז
lehinatez|לְהִינָּתֵז
lenateach|לְנַתֵּחַ
nituach|נִיתּוּחַ
matechet|מַתֶּכֶת
lehatich|לְהַתִּיךְ
latet|לָתֵת
lehinaten|לְהִינָּתֵן
natun|נָתוּן
netunim|נְתוּנִים
matana|מַתָּנָה
lenatetz|לְנַתֵּץ
lehatik|לְהַתִּיק
lehinatek|לְהִינָּתֵק
hinatkut|הִינָּתְקוּת
lehitnatek|לְהִתְנַתֵּק
lenatek|לְנַתֵּק
mutar|מוּתָּר
lenater|לְנַתֵּר
lehatir|לְהַתִּיר
lehatish|לְהַתִּישׁ
hatasha|הַתָּשָׁה
lehista'ev|לְהִסְתָּאֵב
lis'on|לִסְאוֹן
saba|סַבָּא
lehistovev|לְהִסְתּוֹבֵב
lehisov|לְהִיסּוֹב
lesovev|לְסוֹבֵב
lasov|לָסוֹב
lesabev|לְסַבֵּב
sevev|סֵבֶב
sviva|סְבִיבָה
mesiba|מְסִיבָּה
siba|סִיבָּה
lehasev|לְהָסֵב
sabon|סַבּוֹן
lesabech|לְסַבֵּךְ
tisbochet|תִּסְבּוֹכֶת
savuch|סָבוּךְ
lehistabech|לְהִסְתַּבֵּךְ
lisbol|לִסְבּוֹל
sevel|סֵבֶל
sabal|סַבָּל
savlan|סַבְלָן
savlanut|סַבְלָנוּת
lesaben|לְסַבֵּן
lehistaben|לְהִסְתַּבֵּן
lesavsed|לְסַבְסֵד
savur|סָבוּר
lehasbir|לְהַסְבִּיר
svara|סְבָרָה
hesber|הֶסְבֵּר
hasbara|הַסְבָּרָה
histabrut|הִסְתַּבְּרוּת
lisbor|לִסְבּוֹר
lehistaber|לְהִסְתַּבֵּר
savta|סָבְתָא
misgad|מִסְגָּד
lisgod|לִסְגּוֹד
lesagel|לְסַגֵּל
histaglut|הִסְתַּגְּלוּת
mesugal|מְסוּגָּל
sagol|סָגוֹל
lehistagel|לְהִסְתַּגֵּל
sgula|סְגוּלָּה
signon|סִגְנוֹן
lesagnen|לְסַגְנֵן
signun|סִיגְנוּן
lesagseg|לְסַגְסֵג
lehistagef|לְהִסְתַּגֵּף
lesagef|לְסַגֵּף
hasgara|הַסְגָּרָה
lisgor|לִסְגּוֹר
lehisager|לְהִיסָּגֵר
lehasgir|לְהַסְגִּיר
sgira|סְגִירָה
misgeret|מִסְגֶּרֶת
masger|מַסְגֵּר
sagur|סָגוּר
lehistager|לְהִסְתַּגֵּר
sadna|סַדְנָה
sadan|סַדָּן
lehisadek|לְהִיסָּדֵק
lesadek|לְסַדֵּק
sedek|סֶדֶק
lisdok|לִסְדּוֹק
misderon|מִסְדְּרוֹן
lesader|לְסַדֵּר
lehasdir|לְהַסְדִּיר
seder|סֵדֶר
sidra|סִדְרָה
sadar|סַדָּר
sadran|סַדְרָן
sdar|סְדָר
siduri|סִידּוּרִי
lehistader|לְהִסְתַּדֵּר
sidur|סִידּוּר
sahar|סַהַר
soher|סוֹהֵר
sohar|סוֹהַר
saharon|סַהֲרוֹן
laseget|לָסֶגֶת
lesaveg|לְסַווֵּג
sug|סוּג
sod|סוֹד
lehistoded|לְהִסְתּוֹדֵד
lehasvot|לְהַסְווֹת
sus|סוּס
susa|סוּסָה
sof|סוֹף
sufa|סוּפָה
lasur|לָסוּר
lehasit|לְהָסִית
lischov|לִסְחוֹב
lehisachev|לְהִיסָּחֵב
lischot|לִסְחוֹט
lehisachet|לְהִיסָּחֵט
mascheta|מַסְחֵטָה
lischof|לִסְחוֹף
lehisachef|לְהִיסָּחֵף
schofet|סְחוֹפֶת
lischor|לִסְחוֹר
mischar|מִסְחָר
schora|סְחוֹרָה
lesachrer|לְסַחְרֵר
lehistachrer|לְהִסְתַּחְרֵר
sichrur|סִיחְרוּר
listot|לִסְטוֹת
stira|סְטִירָה
listor|לִסְטוֹר
lehistayeg|לְהִסְתַּייֵּג
lesayeg|לְסַייֵּג
histaygut|הִסְתַּייְּגוּת
lesayed|לְסַייֵּד
lehasiach|לְהָסִיחַ
lasiach|לָסִיחַ
lehasit|לְהָסִיט
lehistayem|לְהִסְתַּייֵּם
siyum|סִיּוּם
siyomet|סִיּוֹמֶת
lesayem|לְסַייֵּם
sis|סִיס
lesayea|לְסַייֵּעַ
lehistayea|לְהִסְתַּייֵּעַ
say'an|סַייְעָן
siyua|סִיּוּעַ
lehasir|לְהָסִיר
lesayer|לְסַייֵּר
sayeret|סַייֶּרֶת
siyur|סִיּוּר
sach|סָךְ
liskoch|לִסְכּוֹךְ
lesochech|לְסוֹכֵךְ
lesakech|לְסַכֵּךְ
masach|מָסַךְ
musach|מוּסָךְ
lesakel|לְסַכֵּל
sikul|סִיכּוּל
lehistakel|לְהִסְתַּכֵּל
heskem|הֶסְכֵּם
lesakem|לְסַכֵּם
lehaskim|לְהַסְכִּים
sikum|סִיכּוּם
schum|סְכוּם
liskom|לִסְכּוֹם
lehistakem|לְהִסְתַּכֵּם
mesukan|מְסוּכָּן
lesaken|לְסַכֵּן
sikun|סִיכּוּן
sakana|סַכָּנָה
sochen|סוֹכֵן
sochnut|סוֹכְנוּת
lehaskin|לְהַסְכִּין
lehistaken|לְהִסְתַּכֵּן
sakin|סַכִּין
sichsuch|סִיכְסוּךְ
lehistachsech|לְהִסְתַּכְסֵךְ
lesachsech|לְסַכְסֵךְ
liskor|לִסְכּוֹר
secher|סֶכֶר
lislod|לִסְלוֹד
salon|סָלוֹן
lisloach|לִסְלוֹחַ
lehisaleach|לְהִיסָּלֵחַ
slicha|סְלִיחָה
solela|סוֹלְלָה
lehisalel|לְהִיסָּלֵל
lislol|לִסְלוֹל
mesila|מְסִילָּה
haslama|הַסְלָמָה
lehaslim|לְהַסְלִים
sulam|סוּלָּם
lehistalsel|לְהִסְתַּלְסֵל
lesalsel|לְסַלְסֵל
sela|סֶלַע
lesalef|לְסַלֵּף
lesalek|לְסַלֵּק
lehistalek|לְהִסְתַּלֵּק
siluk|סִילּוּק
lesame|לְסַמֵּא
lehistame|לְהִסְתַּמֵּא
samuy|סָמוּי
lismoch|לִסְמוֹךְ
hasmacha|הַסְמָכָה
mismach|מִסְמָךְ
samich|סָמִיךְ
samuch|סָמוּךְ
smicha|סְמִיכָה
samchut|סַמְכוּת
lehasmich|לְהַסְמִיךְ
lehistamech|לְהִסְתַּמֵּךְ
lesamel|לְסַמֵּל
semel|סֵמֶל
samal|סַמָּל
lesamem|לְסַמֵּם
lesamen|לְסַמֵּן
lehistamen|לְהִסְתַּמֵּן
tismonet|תִּסְמוֹנֶת
lesames|לְסַמֵּס
lesampet|לְסַמְפֵּת
lehasmik|לְהַסְמִיק
lismor|לִסְמוֹר
masmer|מַסְמֵר
lesamer|לְסַמֵּר
lesamrer|לְסַמְרֵר
lesandel|לְסַנְדֵּל
lehistanver|לְהִסְתַּנְווֵר
sanverim|סַנְווֵרִים
lesanver|לְסַנְווֵר
lehistanver|לְהִסְתַּנְווֵר
sinvur|סִינְווּר
histanverut|הִסְתַּנְווְרוּת
santer|סַנְטֵר
lesankren|לְסַנְכְּרֵן
lehistankren|לְהִסְתַּנְכְּרֵן
sinkrun|סִינְכְּרוּן
lesanen|לְסַנֵּן
lehistanen|לְהִסְתַּנֵּן
masnen|מַסְנֵן
histanenut|הִסְתַּנְּנוּת
sinun|סִינּוּן
masnen|מַסְנֵן
tasnin|תַּסְנִין
lesanef|לְסַנֵּף
lehistanef|לְהִסְתַּנֵּף
lis'od|לִסְעוֹד
mis'ada|מִסְעָדָה
se'uda|סְעוּדָה
si'ud|סִיעוּד
lehista'ef|לְהִסְתַּעֵף
lehisa'er|לְהִיסָּעֵר
lehista'er|לְהִסְתַּעֵר
lehas'ir|לְהַסְעִיר
se'ara|סְעָרָה
lis'or|לִסְעוֹר
lispog|לִסְפּוֹג
lehisafeg|לְהִיסָּפֵג
lispod|לִסְפּוֹד
lehisafed|לְהִיסָּפֵד
lehaspid|לְהַסְפִּיד
sapa|סַפָּה
lesapeach|לְסַפֵּחַ
lehisafeach|לְהִיסָּפֵחַ
lispoach|לִסְפּוֹחַ
lehistapeach|לְהִסְתַּפֵּחַ
sipuach|סִיפּוּחַ
lispot|לִסְפּוֹת
lehisafot|לְהִיסָּפוֹת
sefel|סֵפֶל
sefel|סֵפֶל
sifna|סִפְנָה
sapan|סַפָּן
lispon|לִסְפּוֹן
sfina|סְפִינָה
lesafser|לְסַפְסֵר
safsar|סַפְסָר
saf|סַף
sfika|סְפִיקָה
lesapek|לְסַפֵּק
sfika|סְפִיקָה
lehistapek|לְהִסְתַּפֵּק
lehaspik|לְהַסְפִּיק
lispok|לִסְפּוֹק
sapak|סַפָּק
safek|סָפֵק
haspaka|הַסְפָּקָה
aspaka|אַסְפָּקָה
lispor|לִסְפּוֹר
lehistaper|לְהִסְתַּפֵּר
sifriya|סִפְרִייָּה
sefer|סֵפֶר
sapar|סַפָּר
sipur|סִיפּוּר
sifra|סִפְרָה
tisporet|תִּסְפּוֹרֶת
mispara|מִסְפָּרָה
mispar|מִסְפָּר
lehisafer|לְהִיסָּפֵר
sifrut|סִפְרוּת
sifruti|סִפְרוּתִי
sfira|סְפִירָה
lesaper|לְסַפֵּר
misparayim|מִסְפָּרַייִם
sfarad|סְפָרַד
sfaradi|סְפָרַדִּי
lesafret|לְסַפְרֵת
skila|סְקִילָה
liskol|לִסְקוֹל
lesakel|לְסַקֵּל
lehisakel|לְהִיסָּקֵל
sakran|סַקְרָן
liskor|לִסְקוֹר
lesaker|לְסַקֵּר
lehisaker|לְהִיסָּקֵר
seker|סֶקֶר
lesakren|לְסַקְרֵן
lehistakren|לְהִסְתַּקְרֵן
lesarev|לְסָרֵב
lesarbel|לְסַרְבֵּל
lisrog|לִסְרוֹג
lehisareg|לְהִיסָּרֵג
lehasriach|לְהַסְרִיחַ
serachon|סֵירָחוֹן
lisrot|לִסְרוֹט
lehisaret|לְהִיסָּרֵט
lehasrit|לְהַסְרִיט
hasrata|הַסְרָטָה
seret|סֶרֶט
masreta|מַסְרֵטָה
tasrit|תַּסְרִיט
lesares|לְסָרֵס
saris|סָרִיס
srika|סְרִיקָה
lehisarek|לְהִיסָּרֵק
lesarek|לְסָרֵק
lehistarek|לְהִסְתָּרֵק
tisroket|תִּסְרוֹקֶת
masrek|מַסְרֵק
lisrok|לִסְרוֹק
srak|סְרָק
stav|סְתָיו
lehisatem|לְהִיסָּתֵם
satum|סָתוּם
listom|לִסְתּוֹם
lehisater|לְהִיסָּתֵר
listor|לִסְתּוֹר
lehistater|לְהִסְתַּתֵּר
mistor|מִסְתּוֹר
stira|סְתִירָה
lehastir|לְהַסְתִּיר
nistar|נִסְתָּר
lesatet|לְסַתֵּת
le'abed|לְעַבֵּד
leha'avid|לְהַעֲבִיד
ibud|עִיבּוּד
avoda|עֲבוֹדָה
eved|עֶבֶד
uvda|עוּבְדָּה
avdut|עַבְדוּת
ma'abada|מַעְבָּדָה
la'avod|לַעֲבוֹד
avur|עֲבוּר
le'abot|לְעַבּוֹת
lehit'abot|לְהִתְעַבּוֹת
la'avot|לַעֲבוֹת
leha'avir|לְהַעֲבִיר
le'aber|לְעַבֵּר
lehit'aber|לְהִתְעַבֵּר
ma'avar|מַעֲבָר
avaryan|עֲבַרְייָן
ivri|עִבְרִי
la'avor|לַעֲבוֹר
avar|עָבָר
le'avret|לְעַבְרֵת
lehit'avret|לְהִתְעַבְרֵת
lehit'abesh|לְהִתְעַבֵּשׁ
agevet|עַגֶּבֶת
la'agov|לַעֲגוֹב
aga|עָגָה
le'agel|לְעַגֵּל
lehit'agel|לְהִתְעַגֵּל
igul|עִיגּוּל
agol|עָגוֹל
agalgal|עֲגַלְגַּל
le'agen|לְעַגֵּן
ogen|עוֹגֶן
la'agon|לַעֲגוֹן
ad|עַד
ad|עַד
adi|עֲדִי
adayin|עֲדַייִן
lehit'adken|לְהִתְעַדְכֵּן
le'adken|לְעַדְכֵּן
lehit'aden|לְהִתְעַדֵּן
adin|עָדִין
le'aden|לְעַדֵּן
adif|עָדִיף
leha'adif|לְהַעֲדִיף
odef|עוֹדֶף
lehe'ader|לְהֵיעָדֵר
la'ador|לַעֲדוֹר
adasha|עֲדָשָׁה
adasha|עֲדָשָׁה
leha'iv|לְהָעִיב
la'ug|לָעוּג
uga|עוּגָה
ed|עֵד
lehit'oded|לְהִתְעוֹדֵד
leha'id|לְהָעִיד
le'oded|לְעוֹדֵד
te'uda|תְּעוּדָה
od|עוֹד
leha'iz|לְהָעִיז
la'ut|לָעוּט
le'avot|לְעַוּוֹת
avon|עָווֹן
leha'avot|לְהַעֲווֹת
ma'on|מָעוֹן
ona|עוֹנָה
leha'if|לְהָעִיף
la'uf|לָעוּף
lehit'ofef|לְהִתְעוֹפֵף
te'ufa|תְּעוּפָה
le'ofef|לְעוֹפֵף
leha'ik|לְהָעִיק
lehit'orer|לְהִתְעוֹרֵר
lehe'or|לְהֵיעוֹר
leha'ir|לְהָעִיר
le'orer|לְעוֹרֵר
lehit'aver|לְהִתְעַווֵּר
la'ur|לָעוּר
iver|עִיווֵּר
he'ara|הֶעָרָה
me'ara|מְעָרָה
or|עוֹר
le'aver|לְעַווֵּר
ivut|עִיוּוּת
lehit'avet|לְהִתְעַווֵּת
le'avet|לְעַווֵּת
la'azov|לַעֲזוֹב
lehe'azev|לְהֵיעָזֵב
oz|עוֹז
leha'ez|לְהָעֵז
ma'oz|מָעוֹז
az|עַז
lehe'azer|לְהֵיעָזֵר
ezra|עֶזְרָה
ezer|עֵזֶר
la'azor|לַעֲזוֹר
et|עֵט
la'atot|לַעֲטוֹת
leha'atot|לְהַעֲטוֹת
atalef|עֲטַלֵּף
la'atof|לַעֲטוֹף
lehe'atef|לְהֵיעָטֵף
lehit'atef|לְהִתְעַטֵּף
ma'atafa|מַעֲטָפָה
le'ater|לְעַטֵּר
lehe'ater|לְהֵיעָטֵר
la'ator|לַעֲטוֹר
lehit'atesh|לְהִתְעַטֵּשׁ
ayit|עַיִט
le'ayen|לְעַייֵּן
iyun|עִיּוּן
ayin|עַיִן
la'ayon|לַעֲיוֹן
ma'ayan|מַעֲייָן
ayef|עָייֵף
lehit'ayef|לְהִתְעַייֵּף
le'ayef|לְעַייֵּף
ayir|עַיִר
ir|עִיר
erom|עֵירוֹם
le'akev|לְעַכֵּב
lehit'akev|לְהִתְעַכֵּב
ikuv|עִיכּוּב
le'akel|לְעַכֵּל
lehit'akel|לְהִתְעַכֵּל
lehe'achel|לְהֵיעָכֵל
ikul|עִיכּוּל
lehe'acher|לְהֵיעָכֵר
leha'achir|לְהַעֲכִיר
la'achor|לַעֲכוֹר
achshav|עַכְשָׁיו
al|עַל
algav|עַל גַּב
algabei|עַל גַּבֵּי
alyad|עַל יַד
alyedei|עַל יְדֵי
alpi|עַל פִּי
alpnei|עַל פְּנֵי
ha'ala'a|הַעֲלָאָה
elbon|עֶלְבּוֹן
ha'alava|הַעֲלָבָה
lehe'alev|לְהֵיעָלֵב
leha'aliv|לְהַעֲלִיב
la'alov|לַעֲלוֹב
ma'ala|מַעֲלָה
elyonut|עֶלְיוֹנוּת
elyon|עֶלְיוֹן
lehit'alot|לְהִתְעַלּוֹת
mala|מַעְלָה
na'ale|נַעֲלֶה
leha'alot|לְהַעֲלוֹת
me'ule|מְעוּלֶּה
ale|עָלֶה
lemala|לְמַעְלָה
aliya|עֲלִיָּה
alut|עֲלוּת
la'alot|לַעֲלוֹת
lehit'alel|לְהִתְעַלֵּל
le'olel|לְעוֹלֵל
alila|עֲלִילָה
alila|עֲלִילָה
alul|עָלוּל
hit'alelut|הִתְעַלְּלוּת
alma|עַלְמָה
elem|עֶלֶם
lehe'alem|לְהֵיעָלֵם
leha'alim|לְהַעֲלִים
lehit'alem|לְהִתְעַלֵּם
olam|עוֹלָם
ha'alama|הַעֲלָמָה
olami|עוֹלָמִי
he'almut|הֵיעָלְמוּת
lehit'ales|לְהִתְעַלֵּס
le'al'el|לְעַלְעֵל
le'alef|לְעַלֵּף
lehit'alef|לְהִתְעַלֵּף
im|עִם
la'amod|לַעֲמוֹד
lehe'amed|לְהֵיעָמֵד
leha'amid|לְהַעֲמִיד
mo'omad|מוֹעֳמָד
le'amed|לְעַמֵּד
imud|עִימּוּד
amud|עַמּוּד
ma'amad|מַעֲמָד
amida|עֲמִידָה
amid|עָמִיד
amidut|עָמִידוּת
emda|עֶמְדָּה
mo'omadut|מוֹעֳמָדוּת
lehit'amel|לְהִתְעַמֵּל
hit'amlut|הִתְעַמְּלוּת
la'amol|לַעֲמוֹל
am|עַם
le'amem|לְעַמֵּם
mu'am|מוּעָם
la'amom|לַעֲמוֹם
amus|עָמוּס
omes|עוֹמֶס
leha'amis|לְהַעֲמִיס
la'amos|לַעֲמוֹס
le'am'em|לְעַמְעֵם
leha'amik|לְהַעֲמִיק
lehit'amek|לְהִתְעַמֵּק
omek|עוֹמֶק
amok|עָמוֹק
emek|עֵמֶק
omer|עוֹמֶר
lehit'amer|לְהִתְעַמֵּר
lehit'amet|לְהִתְעַמֵּת
le'amet|לְעַמֵּת
imut|עִימּוּת
le'umat|לְעוּמַּת
ma'amat|מַעֲמָת
amuta|עֲמוּתָּה
la'anov|לַעֲנוֹב
aniva|עֲנִיבָה
le'aneg|לְעַנֵּג
lehit'aneg|לְהִתְעַנֵּג
ta'anug|תַּעֲנוּג
la'anod|לַעֲנוֹד
ez|עֵז
la'anot|לַעֲנוֹת
le'anot|לְעַנּוֹת
lehit'anot|לְהִתְעַנּוֹת
lehe'anot|לְהֵיעָנוֹת
oni|עוֹנִי
he'anut|הֵיעָנוּת
ta'anit|תַּעְנִית
ma'ane|מַעֲנֶה
ani|עָנִי
inyan|עִנְייָן
le'anyen|לְעַנְייֵן
lehit'anyen|לְהִתְעַנְייֵן
me'anyen|מְעַנְייֵן
lehit'anen|לְהִתְעַנֵּן
anan|עָנָן
leha'anik|לְהַעֲנִיק
anak|עֲנָק
lehe'anesh|לְהֵיעָנֵשׁ
leha'anish|לְהַעֲנִישׁ
onesh|עוֹנֶשׁ
la'anosh|לַעֲנוֹשׁ
le'asot|לְעַסּוֹת
isuy|עִיסּוּי
asis|עָסִיס
asisi|עֲסִיסִי
lehit'asek|לְהִתְעַסֵּק
leha'asik|לְהַעֲסִיק
iska|עִסְקָה
la'asok|לַעֲסוֹק
ha'apala|הַעְפָּלָה
leha'apil|לְהַעְפִּיל
le'af'ef|לְעַפְעֵף
iparon|עִיפָּרוֹן
leha'atziv|לְהַעֲצִיב
lehe'atzev|לְהֵיעָצֵב
le'atzev|לְעַצֵּב
etzev|עֶצֶב
atzav|עָצָב
atzuv|עָצוּב
itzuv|עִיצּוּב
lehit'atzev|לְהִתְעַצֵּב
lehit'atzben|לְהִתְעַצְבֵּן
le'atzben|לְעַצְבֵּן
etz|עֵץ
lehit'atzel|לְהִתְעַצֵּל
atzel|עָצֵל
atzlan|עַצְלָן
atzlan|עַצְלָן
atzlut|עַצְלוּת
ma'atzama|מַעֲצָמָה
la'atzom|לַעֲצוֹם
lehe'atzem|לְהֵיעָצֵם
lehit'atzem|לְהִתְעַצֵּם
otzma|עוֹצְמָה
etzem|עֶצֶם
etzem|עֶצֶם
atzuma|עֲצוּמָה
itzum|עִיצּוּם
leha'atzim|לְהַעֲצִים
la'atzor|לַעֲצוֹר
lehe'atzer|לְהֵיעָצֵר
atzir|עָצִיר
ma'atzar|מַעֲצָר
akov|עָקוֹב
akev|עָקֵב
akev|עָקֵב
la'akov|לַעֲקוֹב
la'akod|לַעֲקוֹד
lehit'akel|לְהִתְעַקֵּל
le'akel|לְעַקֵּל
le'akem|לְעַקֵּם
lehit'akem|לְהִתְעַקֵּם
lehe'akef|לְהֵיעָקֵף
la'akof|לַעֲקוֹף
la'akotz|לַעֲקוֹץ
lehe'aketz|לְהֵיעָקֵץ
lehe'aker|לְהֵיעָקֵר
ikaron|עִיקָּרוֹן
ekroni|עֶקְרוֹנִי
le'aker|לְעַקֵּר
ikar|עִיקָר
la'akor|לַעֲקוֹר
lehit'akesh|לְהִתְעַקֵּשׁ
ikesh|עִיקֵּשׁ
la'arov|לַעֲרוֹב
le'arev|לְעָרֵב
ma'arav|מַעֲרָב
arvut|עַרְבוּת
erev|עֶרֶב
arev|עָרֵב
arev|עָרֵב
ma'arava|מַעֲרָבָה
ma'aravi|מַעֲרָבִי
arava|עֲרָבָה
lehit'arev|לְהִתְעָרֵב
le'arbev|לְעַרְבֵּב
lehit'arbev|לְהִתְעַרְבֵּב
lehit'arbel|לְהִתְעַרְבֵּל
le'arbel|לְעַרְבֵּל
le'argel|לְעַרְגֵּל
ma'arachon|מַעֲרָכוֹן
la'aroch|לַעֲרוֹךְ
lehe'arech|לְהֵיעָרֵךְ
leha'arich|לְהַעֲרִיךְ
erech|עֵרֶךְ
ha'aracha|הַעֲרָכָה
ma'arach|מַעֲרָךְ
ma'aracha|מַעֲרָכָה
ma'arechet|מַעֲרֶכֶת
orla|עוֹרְלָה
la'arom|לַעֲרוֹם
lehe'arem|לְהֵיעָרֵם
leha'arim|לְהַעֲרִים
arom|עָרוֹם
arum|עָרוּם
arisa|עֲרִיסָה
le'ar'er|לְעַרְעֵר
lehit'ar'er|לְהִתְעַרְעֵר
ir'ur|עִירְעוּר
la'arof|לַעֲרוֹף
oref|עוֹרֶף
le'arpel|לְעַרְפֵּל
arafel|עֲרָפֶל
leha'aritz|לְהַעֲרִיץ
aritz|עָרִיץ
lehe'aretz|לְהֵיעָרֵץ
ha'aratza|הַעֲרָצָה
la'arok|לַעֲרוֹק
la'aror|לַעֲרוֹר
le'asev|לְעַשֵּׂב
esev|עֵשֶׂב
la'asot|לַעֲשׂוֹת
ta'asiya|תַּעֲשִׂיָּה
lehe'asot|לְהֵיעָשׂוֹת
asuy|עָשׂוּי
ma'ase|מַעֲשֶׂה
le'asot|לְעַשּׂוֹת
me'use|מְעוּשֶּׂה
le'ashen|לְעַשֵּׁן
ishun|עִישּׁוּן
ashan|עָשָׁן
me'ushan|מְעוּשָּׁן
la'ashok|לַעֲשׁוֹק
leha'ashir|לְהַעֲשִׁיר
lehit'asher|לְהִתְעַשֵּׁר
asiri|עֲשִׂירִי
asor|עָשׂוֹר
le'aser|לְעַשֵּׂר
ashir|עָשִׁיר
osher|עוֹשֶׁר
lehit'ashet|לְהִתְעַשֵּׁת
atid|עָתִיד
atid|עָתִיד
lehit'ated|לְהִתְעַתֵּד
ituy|עִיתּוּי
he'etek|הֶעְתֵּק
leha'atik|לְהַעְתִּיק
atik|עַתִּיק
ta'atik|תַּעְתִּיק
lehe'atek|לְהֵיעָתֵק
oter|עוֹתֵר
la'ator|לַעֲתוֹר
lehe'ater|לְהֵיעָתֵר
leha'atir|לְהַעֲתִיר
leha'atir|לְהַעֲתִיר
atira|עֲתִירָה
et|עֵת
iton|עִיתּוֹן
itonay|עִיתּוֹנַאי
itonut|עִיתּוֹנוּת
itona'ut|עִיתּוֹנָאוּת
ata|עַתָּה
lefa'er|לְפָאֵר
lehitpa'er|לְהִתְפָּאֵר
tif'eret|תִּפְאֶרֶת
pe'er|פְּאֵר
lehafgiz|לְהַפְגִּיז
pagaz|פָּגָז
pgima|פְּגִימָה
pagum|פָּגוּם
lehipagem|לְהִיפָּגֵם
pigum|פִּיגּוּם
pgam|פְּגָם
lifgom|לִפְגּוֹם
lehafgin|לְהַפְגִּין
hafgana|הַפְגָּנָה
lehipagea|לְהִיפָּגֵעַ
pgi'a|פְּגִיעָה
pigua|פִּיגּוּעַ
lifgoa|לִפְגּוֹעַ
lehafgia|לְהַפְגִּיעַ
lifgor|לִפְגּוֹר
lefager|לְפַגֵּר
pigur|פִּיגּוּר
mefager|מְפַגֵּר
lehitpager|לְהִתְפַּגֵּר
lifgosh|לִפְגּוֹשׁ
lehipagesh|לְהִיפָּגֵשׁ
lehafgish|לְהַפְגִּישׁ
pgisha|פְּגִישָׁה
pagosh|פָּגוֹשׁ
lehipadot|לְהִיפָּדוֹת
lifdot|לִפְדּוֹת
lefader|לְפַדֵּר
lehitpader|לְהִתְפַּדֵּר
pe|פֶּה
po|פֹּה
lefahek|לְפַהֵק
lafug|לָפוּג
lehafig|לְהָפִיג
lehitpogeg|לְהִתְפּוֹגֵג
lehafiach|לְהָפִיחַ
pol|פּוֹל
politika|פּוֹלִיטִיקָה
pundak|פּוּנְדָּק
pundeka'ut|פּוּנְדְּקָאוּת
pundekay|פּוּנְדְּקַאי
pundeka'it|פּוּנְדְּקָאִית
lehafitz|לְהָפִיץ
nafotz|נָפוֹץ
hafatza|הֲפָצָה
lehipetz|לְהִיפֵּץ
lehipotz|לְהִיפּוֹץ
lafutz|לָפוּץ
lehafik|לְהָפִיק
leforer|לְפוֹרֵר
lehitporer|לְהִתְפּוֹרֵר
lifzol|לִפְזוֹל
lefazem|לְפַזֵּם
pizmon|פִּזְמוֹן
lehitpazer|לְהִתְפַּזֵּר
lefazer|לְפַזֵּר
lifchod|לִפְחוֹד
lehafchid|לְהַפְחִיד
lefached|לְפַחֵד
pachad|פַּחַד
pachdan|פַּחְדָן
lifchoz|לִפְחוֹז
lefachem|לְפַחֵם
lehitpachem|לְהִתְפַּחֵם
lifchos|לִפְחוֹס
lifchot|לִפְחוֹת
lehafchit|לְהַפְחִית
pachot|פָּחוֹת
lefatem|לְפַטֵּם
lehitpatem|לְהִתְפַּטֵּם
lefatpet|לְפַטְפֵּט
lehipater|לְהִיפָּטֵר
lefater|לְפַטֵּר
patur|פָּטוּר
ptor|פְּטוֹר
lehitpater|לְהִתְפַּטֵּר
liftor|לִפְטוֹר
lehaftir|לְהַפְטִיר
patish|פַּטִּישׁ
lefayeach|לְפַייֵּחַ
pil|פִּיל
filosofya|פִילוֹסוֹפְיָה
lehitpayes|לְהִתְפַּייֵּס
lefayes|לְפַייֵּס
hitpaysut|הִתְפַּייְּסוּת
piyus|פִּיּוּס
lehitpakeach|לְהִתְפַּכֵּחַ
lefakot|לְפַכּוֹת
lehitpale|לְהִתְפַּלֵּא
lehafli|לְהַפְלִיא
pele|פֶּלֶא
lehipale|לְהִיפָּלֵא
nifla|נִפְלָא
falafel|פָלָאפֶל
lefaleg|לְפַלֵּג
lehitpaleg|לְהִתְפַּלֵּג
lehaflig|לְהַפְלִיג
pluga|פְּלוּגָּה
miflaga|מִפְלָגָה
hitpalgut|הִתְפַּלְּגוּת
plada|פְּלָדָה
lefaleach|לְפַלֵּחַ
pelach|פֶּלַח
lifloach|לִפְלוֹחַ
palit|פָּלִיט
lehipalet|לְהִיפָּלֵט
liflot|לִפְלוֹט
lehaflit|לְהַפְלִיט
lehaflot|לְהַפְלוֹת
haflaya|הַפְלָיָה
aflaya|אַפְלָיָה
pelech|פֶּלֶךְ
lehaflil|לְהַפְלִיל
lefalel|לְפַלֵּל
lehitpalel|לְהִתְפַּלֵּל
plili|פְּלִילִי
tfila|תְּפִילָּה
miflas|מִפְלָס
lefales|לְפַלֵּס
lehitpalsef|לְהִתְפַּלְסֵף
lefalpel|לְפַלְפֵּל
lehaflitz|לְהַפְלִיץ
mifletzet|מִפְלֶצֶת
liflartet|לִפְלַרְטֵט
liflosh|לִפְלוֹשׁ
lehitpalesh|לְהִתְפַּלֵּשׁ
pamot|פָּמוֹט
lefampem|לְפַמְפֵּם
pen|פֶּן
pan|פָּן
pnay|פְּנַאי
mefuntaz|מְפוּנְטָז
lefantez|לְפַנְטֵז
lifnot|לִפְנוֹת
lehipanot|לְהִיפָּנוֹת
lefanot|לְפַנּוֹת
lehafnot|לְהַפְנוֹת
panuy|פָּנוּי
pinuy|פִּינּוּי
pniya|פְּנִיָּה
lehitpanot|לְהִתְפַּנּוֹת
panim|פָּנִים
pnim|פְּנִים
lehafnim|לְהַפְנִים
pnimi|פְּנִימִי
panas|פָּנָס
lefanek|לְפַנֵּק
lehitpanek|לְהִתְפַּנֵּק
pisga|פִּסְגָּה
lehafsid|לְהַפְסִיד
hefsed|הֶפְסֵד
nifsad|נִפְסָד
lifsoach|לִפְסוֹחַ
lehipaseach|לְהִיפָּסֵחַ
psichologya|פְּסִיכוֹלוֹגְיָה
lefasel|לְפַסֵּל
lehipasel|לְהִיפָּסֵל
pesel|פֶּסֶל
psolet|פְּסוֹלֶת
mafselet|מַפְסֶלֶת
pasal|פַּסָּל
pasul|פָּסוּל
lifsol|לִפְסוֹל
psanter|פְּסַנְתֵּר
pas|פַּס
lifsoa|לִפְסוֹעַ
lefasfes|לְפַסְפֵס
lehitfasfes|לְהִתְפַסְפֵס
lehipasek|לְהִיפָּסֵק
lehafsik|לְהַפְסִיק
hafsaka|הַפְסָקָה
hefsek|הֶפְסֵק
psik|פְּסִיק
psak|פְּסָק
pesek|פֶּסֶק
mafsek|מַפְסֵק
mafsik|מַפְסִיק
lifsok|לִפְסוֹק
piska|פִּסְקָה
pa'ot|פָּעוֹט
lif'ot|לִפְעוֹת
pe'ilut|פְּעִילוּת
lif'ol|לִפְעוֹל
lehaf'il|לְהַפְעִיל
pe'ula|פְּעוּלָּה
pa'il|פָּעִיל
po'al|פּוֹעַל
mif'al|מִפְעָל
pe'altan|פְּעַלְתָּן
po'el|פּוֹעֵל
pa'il|פָּעִיל
lehitpa'el|לְהִתְפַּעֵל
lehitpa'em|לְהִתְפַּעֵם
pa'amon|פַּעֲמוֹן
lif'om|לִפְעוֹם
lehipa'em|לְהִיפָּעֵם
lehaf'im|לְהַפְעִים
pa'am|פַּעַם
lefa'em|לְפַעֵם
lefa'aneach|לְפַעְנֵחַ
lefa'apea|לְפַעְפֵּעַ
pa'ar|פַּעַר
lif'or|לִפְעוֹר
lehipa'er|לְהִיפָּעֵר
lefatzeach|לְפַצֵּחַ
liftzot|לִפְצוֹת
lefatzot|לְפַצּוֹת
pitzuy|פִּיצּוּי
lefatzel|לְפַצֵּל
lehitpatzel|לְהִתְפַּצֵּל
lehipatzea|לְהִיפָּצֵעַ
liftzoa|לִפְצוֹעַ
patzua|פָּצוּעַ
lehaftzia|לְהַפְצִיעַ
lefatzpetz|לְפַצְפֵּץ
lehitpatzpetz|לְהִתְפַּצְפֵּץ
lefotzetz|לְפוֹצֵץ
ptzatza|פְּצָצָה
lehaftzitz|לְהַפְצִיץ
lehitpotzetz|לְהִתְפּוֹצֵץ
lehaftzir|לְהַפְצִיר
lehipaked|לְהִיפָּקֵד
lefaked|לְפַקֵּד
lehafkid|לְהַפְקִיד
lifkod|לִפְקוֹד
pkuda|פְּקוּדָּה
tafkid|תַּפְקִיד
lehitpaked|לְהִתְפַּקֵּד
lifkoach|לִפְקוֹחַ
lehipakeach|לְהִיפָּקֵחַ
lefakeach|לְפַקֵּחַ
lehitpakeach|לְהִתְפַּקֵּחַ
pakuach|פָּקוּחַ
pikuach|פִּיקּוּחַ
pikeach|פִּיקֵּחַ
lefakses|לְפַקְסֵס
lehafkia|לְהַפְקִיעַ
lehitpakea|לְהִתְפַּקֵּעַ
lifkoa|לִפְקוֹעַ
lefakpek|לְפַקְפֵּק
pika|פִּיקָּה
pakeket|פַּקֶּקֶת
pkak|פְּקָק
lehafkir|לְהַפְקִיר
lehitfakshesh|לְהִתְפַקְשֵׁשׁ
par|פַּר
lefargen|לְפַרְגֵּן
lesablet|לְסַבְּלֵט
parud|פָּרוּד
lehafrid|לְהַפְרִיד
lehipared|לְהִיפָּרֵד
preda|פְּרֵידָה
hafrada|הַפְרָדָה
para|פָּרָה
parvar|פַּרְווָר
lefarez|לְפָרֵז
lehafriz|לְהַפְרִיז
lifroach|לִפְרוֹחַ
lehafriach|לְהַפְרִיחַ
perach|פֶּרַח
pricha|פְּרִיחָה
tafrit|תַּפְרִיט
prit|פְּרִיט
prati|פְּרָטִי
lehiparet|לְהִיפָּרֵט
lefaret|לְפָרֵט
prat|פְּרָט
lehafrit|לְהַפְרִיט
hafrata|הַפְרָטָה
lifrot|לִפְרוֹט
lifrot|לִפְרוֹת
lehafrot|לְהַפְרוֹת
hafraya|הַפְרָיָה
piryon|פִּרְיוֹן
pri|פְּרִי
lehafrich|לְהַפְרִיךְ
lefarech|לְפָרֵךְ
perech|פֶּרֶךְ
lefarkes|לְפַרְכֵּס
lehitparkes|לְהִתְפַּרְכֵּס
lehiparem|לְהִיפָּרֵם
perem|פֶּרֶם
lifrom|לִפְרוֹם
parnasa|פַּרְנָסָה
parnas|פַּרְנָס
lehitparnes|לְהִתְפַּרְנֵס
lefarnes|לְפַרְנֵס
lifros|לִפְרוֹס
lehipares|לְהִיפָּרֵס
lehitpares|לְהִתְפָּרֵס
pras|פְּרָס
prisa|פְּרִיסָה
lehitparsem|לְהִתְפַּרְסֵם
lefarsem|לְפַרְסֵם
pirsum|פִּירְסוּם
pirsomet|פִּירְסוֹמֶת
lehitparea|לְהִתְפָּרֵעַ
lehafria|לְהַפְרִיעַ
lifroa|לִפְרוֹעַ
lehiparea|לְהִיפָּרֵעַ
lifrof|לִפְרוֹף
lehitparper|לְהִתְפַּרְפֵּר
lefarper|לְפַרְפֵּר
parpar|פַּרְפָּר
lifrotz|לִפְרוֹץ
lehiparetz|לְהִיפָּרֵץ
mifratz|מִפְרָץ
pritza|פְּרִיצָה
peretz|פֶּרֶץ
lehitparetz|לְהִתְפָּרֵץ
partzuf|פַּרְצוּף
lefarek|לְפָרֵק
lehitparek|לְהִתְפָּרֵק
perek|פֶּרֶק
mifrak|מִפְרָק
lifrok|לִפְרוֹק
lehiparek|לְהִיפָּרֵק
lefarked|לְפַרְקֵד
praklit|פְּרַקְלִיט
lehitporer|לְהִתְפּוֹרֵר
leforer|לְפוֹרֵר
hafara|הֲפָרָה
lehafer|לְהָפֵר
perush|פֵּירוּשׁ
lehafrish|לְהַפְרִישׁ
lefaresh|לְפָרֵשׁ
lehipares|לְהִיפָּרֵשׂ
parash|פָּרָשׁ
hefresh|הֶפְרֵשׁ
mifras|מִפְרָשׂ
lehitparesh|לְהִתְפָּרֵשׁ
lifrosh|לִפְרוֹשׁ
lifros|לִפְרוֹשׂ
lefarshen|לְפַרְשֵׁן
lefashet|לְפַשֵּׁט
pashut|פָּשׁוּט
hafshata|הַפְשָׁטָה
lehafshit|לְהַפְשִׁיט
lifshot|לִפְשׁוֹט
lehipashet|לְהִיפָּשֵׁט
lehitpashet|לְהִתְפַּשֵּׁט
lifsot|לִפְשׂוֹת
lehitfashel|לְהִתְפַשֵּׁל
lehafshil|לְהַפְשִׁיל
lefashel|לְפַשֵּׁל
lifshoa|לִפְשׁוֹעַ
lefashpesh|לְפַשְׁפֵּשׁ
pishpesh|פִּישְׁפֵּשׁ
lifshok|לִפְשׁוֹק
lifsok|לִפְשׂוֹק
lefasek|לְפַשֵּׂק
lefasher|לְפַשֵּׁר
lehitpasher|לְהִתְפַּשֵּׁר
lehafshir|לְהַפְשִׁיר
pshara|פְּשָׁרָה
posher|פּוֹשֵׁר
hitpatchut|הִתְפַּתְּחוּת
pituach|פִּיתּוּחַ
lehipateach|לְהִיפָּתֵחַ
lefateach|לְפַתֵּחַ
lehitpateach|לְהִתְפַּתֵּחַ
petach|פֶּתַח
pticha|פְּתִיחָה
mafteach|מַפְתֵּחַ
patuach|פָּתוּחַ
liftoach|לִפְתּוֹחַ
lefatot|לְפַתּוֹת
pituy|פִּיתּוּי
lehitpatot|לְהִתְפַּתּוֹת
pitayon|פִּיתָּיוֹן
lefatel|לְפַתֵּל
lehitpatel|לְהִתְפַּתֵּל
pitul|פִּיתּוּל
ptil|פְּתִיל
lehaftia|לְהַפְתִּיעַ
hafta'a|הַפְתָּעָה
liftor|לִפְתּוֹר
lehipater|לְהִיפָּתֵר
pitron|פִּתְרוֹן
pita|פִּיתָּה
pat|פַּת
tze'etza|צֶאֱצָא
lehatzbi|לְהַצְבִּיא
tzava|צָבָא
tzav|צַב
litzbot|לִצְבּוֹט
lehitzavet|לְהִיצָּבֵט
tziv'oni|צִבְעוֹנִי
tzeva|צֶבַע
litzboa|לִצְבּוֹעַ
lehitzavea|לְהִיצָּבֵעַ
lehatzbia|לְהַצְבִּיעַ
tzaba|צַבָּע
etzba|אֶצְבַּע
litzbor|לִצְבּוֹר
lehitzaver|לְהִיצָּבֵר
lehitztaber|לְהִצְטַבֵּר
matzber|מַצְבֵּר
tzibur|צִיבּוּר
tziburi|צִיבּוּרִי
tzvat|צְבָת
tzad|צַד
letzaded|לְצַדֵּד
lehatzdia|לְהַצְדִּיעַ
hatzda'a|הַצְדָּעָה
lehitztadek|לְהִצְטַדֵּק
litzdok|לִצְדּוֹק
lehatzdik|לְהַצְדִּיק
tzdaka|צְדָקָה
hatzdaka|הַצְדָּקָה
tzedek|צֶדֶק
tzadik|צַדִּיק
tzadik|צַדִּיק
mutzdak|מוּצְדָּק
tzehavhav|צְהַבְהַב
lehatzhiv|לְהַצְהִיב
tzahov|צָהוֹב
litzhol|לִצְהוֹל
tzohorayim|צוֹהֳרַייִם
lehatzhir|לְהַצְהִיר
hatzhara|הַצְהָרָה
tzohorayim|צוֹהֳרַייִם
latzud|לָצוּד
lehitzod|לְהִיצּוֹד
litzvoach|לִצְווֹחַ
lehitztavot|לְהִצְטַוּוֹת
mitzva|מִצְווָה
tzav|צַו
letzavot|לְצַוּוֹת
tzol|צוֹל
latzum|לָצוּם
tzom|צוֹם
latzuf|לָצוּף
lehatzif|לְהָצִיף
hatzafa|הֲצָפָה
lehatzitz|לְהָצִיץ
hatzatza|הֲצָצָה
latzutz|לָצוּץ
lehatzik|לְהָצִיק
metzuka|מְצוּקָה
hatzaka|הֲצָקָה
matzor|מָצוֹר
tzura|צוּרָה
latzur|לָצוּר
tzevet|צֶווֶת
tzach|צַח
letzachtzeach|לְצַחְצֵחַ
litzchok|לִצְחוֹק
lehatzchik|לְהַצְחִיק
tzchok|צְחוֹק
letzachek|לְצַחֵק
letzachkek|לְצַחְקֵק
letzatet|לְצַטֵּט
tzi|צִי
letzayed|לְצַייֵּד
lehitztayed|לְהִצְטַייֵּד
tziyud|צִיּוּד
letzayen|לְצַייֵּן
lehitztayen|לְהִצְטַייֵּן
tzinor|צִינּוֹר
tzini|צִינִי
tziniyut|צִינִיּוּת
tziporen|צִיפּוֹרֶן
tziporen|צִיפּוֹרֶן
tziporen|צִיפּוֹרֶן
letzayetz|לְצַייֵּץ
tziyutz|צִיּוּץ
lehitztayer|לְהִצְטַייֵּר
tzayar|צַייָּר
letzayer|לְצַייֵּר
tziyur|צִיּוּר
tzaytan|צַייְתָן
letzayet|לְצַייֵּת
tzalvan|צַלְבָן
tzlav|צְלָב
lehitztalev|לְהִצְטַלֵּב
lehatzliv|לְהַצְלִיב
hatzlacha|הַצְלָחָה
mutzlach|מוּצְלָח
litzloach|לִצְלוֹחַ
lehatzliach|לְהַצְלִיחַ
tzalachat|צַלַּחַת
lehitzalot|לְהִיצָּלוֹת
litzlot|לִצְלוֹת
litzlol|לִצְלוֹל
tzlil|צְלִיל
tzel|צֵל
lehatzel|לְהָצֵל
lehitztalel|לְהִצְטַלֵּל
letzalem|לְצַלֵּם
lehitztalem|לְהִצְטַלֵּם
tzelem|צֶלֶם
tzalam|צַלָּם
tzilum|צִילּוּם
matzlema|מַצְלֵמָה
tatzlum|תַּצְלוּם
litzloa|לִצְלוֹעַ
tzela|צֶלַע
lehatzlif|לְהַצְלִיף
tzalaf|צַלָּף
litzlof|לִצְלוֹף
letzaltzel|לְצַלְצֵל
tzaleket|צַלֶּקֶת
tzame|צָמֵא
litzmo|לִצְמוֹא
tzima'on|צִימָּאוֹן
lehatzmid|לְהַצְמִיד
lehitzamed|לְהִיצָּמֵד
tzamid|צָמִיד
litzmoach|לִצְמוֹחַ
lehatzmiach|לְהַצְמִיחַ
tzimchoni|צִמְחוֹנִי
tzimchonut|צִמְחוֹנוּת
tzemach|צֶמַח
lehitztamtzem|לְהִצְטַמְצֵם
tzamtzam|צַמְצָם
letzamtzem|לְצַמְצֵם
lehitztamek|לְהִצְטַמֵּק
tzemer|צֶמֶר
tzamri|צַמְרִי
tzameret|צַמֶּרֶת
lehitztamrer|לְהִצְטַמְרֵר
tzomet|צוֹמֶת
litzmot|לִצְמוֹת
litznoach|לִצְנוֹחַ
lehatzniach|לְהַצְנִיחַ
tzanchan|צַנְחָן
mitznach|מִצְנָח
matzneach|מַצְנֵחַ
metzunan|מְצוּנָּן
letzanen|לְצַנֵּן
lehitztanen|לְהִצְטַנֵּן
lehatzen|לְהָצֵן
lehitztanea|לְהִצְטַנֵּעַ
lehatznia|לְהַצְנִיעַ
tzanua|צָנוּעַ
lehatznif|לְהַצְנִיף
mitznefet|מִצְנֶפֶת
tzanif|צָנִיף
lehitztanef|לְהִצְטַנֵּף
litznof|לִצְנוֹף
tzantar|צַנְתָּר
letzanter|לְצַנְתֵּר
tzintur|צִינְתּוּר
litz'od|לִצְעוֹד
lehatz'id|לְהַצְעִיד
mitz'ad|מִצְעָד
tza'ad|צַעַד
tze'ida|צְעִידָה
tza'if|צָעִיף
tza'atzua|צַעֲצוּעַ
litz'ok|לִצְעוֹק
tze'aka|צְעָקָה
lehitzta'ek|לְהִצְטַעֵק
letza'er|לְצַעֵר
lehitzta'er|לְהִצְטַעֵר
tza'ir|צָעִיר
mitzpe|מִצְפֶּה
tzafuy|צָפוּי
tzefi|צֶפִי
lehitzafot|לְהִיצָּפוֹת
letzapot|לְצַפּוֹת
litzpot|לִצְפּוֹת
tzipiya|צִיפִּיָּה
matzpen|מַצְפֵּן
litzpon|לִצְפּוֹן
lehitzafen|לְהִיצָּפֵן
tzafon|צָפוֹן
tzofen|צוֹפֶן
tzafona|צָפוֹנָה
tzfoni|צְפוֹנִי
matzpun|מַצְפּוּן
lehatzpin|לְהַצְפִּין
tzafuf|צָפוּף
letzofef|לְצוֹפֵף
lehitztofef|לְהִצְטוֹפֵף
letzaftzef|לְצַפְצֵף
litzpor|לִצְפּוֹר
tzapar|צַפָּר
tzipor|צִיפּוֹר
litzrov|לִצְרוֹב
tzaruv|צָרוּב
tzarevet|צָרֶבֶת
lehitztared|לְהִצְטָרֵד
litzroach|לִצְרוֹחַ
tzarchan|צַרְחָן
tzriach|צְרִיחַ
lehitztarech|לְהִצְטָרֵךְ
litzroch|לִצְרוֹךְ
lehatzrich|לְהַצְרִיךְ
tzarich|צָרִיךְ
tzorech|צוֹרֶךְ
tzarchan|צַרְכָן
mitzrach|מִצְרָךְ
lehitzarech|לְהִיצָּרֵךְ
litzrom|לִצְרוֹם
lehitztaref|לְהִצְטָרֵף
letzaref|לְצָרֵף
tzrif|צְרִיף
litzrof|לִצְרוֹף
letzartzer|לְצַרְצֵר
litzror|לִצְרוֹר
tzar|צַר
lehatzer|לְהָצֵר
letzotet|לְצוֹתֵת
likbol|לִקְבּוֹל
lekabel|לְקַבֵּל
lehitkabel|לְהִתְקַבֵּל
lehakbil|לְהַקְבִּיל
kabala|קַבָּלָה
kibolet|קִיבּוֹלֶת
kabal|קַבָּל
lehikavea|לְהִיקָּבֵעַ
kavua|קָבוּעַ
lehitkabea|לְהִתְקַבֵּעַ
likboa|לִקְבּוֹעַ
kvutza|קְבוּצָה
lehikavetz|לְהִיקָּבֵץ
lekabetz|לְקַבֵּץ
kovetz|קוֹבֶץ
kabtzan|קַבְּצָן
lehitkabetz|לְהִתְקַבֵּץ
kibutz|קִיבּוּץ
likbor|לִקְבּוֹר
lehikaver|לְהִיקָּבֵר
kavur|קָבוּר
kvura|קְבוּרָה
kever|קֵבֶר
kabarnit|קַבַּרְנִיט
lakod|לָקוֹד
lekaded|לְקַדֵּד
kadachat|קַדַּחַת
lehakdiach|לְהַקְדִּיחַ
likdoach|לִקְדּוֹחַ
lehikadeach|לְהִיקָּדֵחַ
makdecha|מַקְדֵּחָה
ekdach|אֶקְדָּח
mukdam|מוּקְדָּם
lekadem|לְקַדֵּם
lehakdim|לְהַקְדִּים
lehitkadem|לְהִתְקַדֵּם
hitkadmut|הִתְקַדְּמוּת
kidma|קִדְמָה
kidomet|קִידּוֹמֶת
kadima|קָדִימָה
hakdama|הַקְדָּמָה
takdim|תַּקְדִּים
likdom|לִקְדּוֹם
lehitkader|לְהִתְקַדֵּר
likdor|לִקְדּוֹר
kadosh|קָדוֹשׁ
lekadesh|לְקַדֵּשׁ
lehitkadesh|לְהִתְקַדֵּשׁ
lehakdish|לְהַקְדִּישׁ
mikdash|מִקְדָּשׁ
kodesh|קוֹדֶשׁ
lehitkahot|לְהִתְקַהוֹת
lehakhot|לְהַקְהוֹת
kehila|קְהִילָּה
lehitkahel|לְהִתְקַהֵל
makhela|מַקְהֵלָה
lehikahel|לְהִיקָּהֵל
kahal|קָהָל
kehilati|קְהִלָּתִי
kav|קַו
lekavot|לְקַוּוֹת
lehikavot|לְהִיקָּווֹת
tikva|תִּקְווָה
kol|קוֹל
kolnoa|קוֹלְנוֹעַ
lakum|לָקוּם
lehakim|לְהָקִים
lekomem|לְקוֹמֵם
lehitkomem|לְהִתְקוֹמֵם
makom|מָקוֹם
tkuma|תְּקוּמָה
yekum|יְקוּם
mekomi|מְקוֹמִי
komunist|קוֹמוּנִיסְט
kina|קִינָה
mekuvan|מְקוּוָּן
lekonen|לְקוֹנֵן
kufsa|קוּפְסָה
lakutz|לָקוּץ
makor|מָקוֹר
lekazez|לְקַזֵּז
lehitkazez|לְהִתְקַזֵּז
lekatev|לְקַטֵּב
lehitkotet|לְהִתְקוֹטֵט
liktol|לִקְטוֹל
lehikatel|לְהִיקָּטֵל
lekatel|לְקַטֵּל
lehitkatel|לְהִתְקַטֵּל
likton|לִקְטוֹן
lehaktin|לְהַקְטִין
katan|קָטָן
liktoa|לִקְטוֹעַ
lehikatea|לְהִיקָּטֵעַ
keta|קֶטַע
liktof|לִקְטוֹף
lehikatef|לְהִיקָּטֵף
ktifa|קְטִיפָה
lekater|לְקַטֵּר
katar|קַטָּר
kitor|קִיטוֹר
lehaktir|לְהַקְטִיר
lehaki|לְהָקִיא
keiva|קֵיבָה
lekayem|לְקַייֵּם
lehitkayem|לְהִתְקַייֵּם
kiyum|קִיּוּם
kayam|קַייָּם
kinamon|קִינָמוֹן
lehakitz|לְהָקִיץ
kayitz|קַיִץ
kir|קִיר
lehaklid|לְהַקְלִיד
haklada|הַקְלָדָה
mikledet|מִקְלֶדֶת
lehitkaleach|לְהִתְקַלֵּחַ
likloach|לִקְלוֹחַ
miklachat|מִקְלַחַת
lekaleach|לְקַלֵּחַ
lehaklit|לְהַקְלִיט
lehikalet|לְהִיקָּלֵט
miklat|מִקְלָט
haklata|הַקְלָטָה
hikaltut|הִיקָּלְטוּת
kaletet|קַלֶּטֶת
maklet|מַקְלֵט
taklit|תַּקְלִיט
liklot|לִקְלוֹט
liklot|לִקְלוֹת
lehikalot|לְהִיקָּלוֹת
kalon|קָלוֹן
kalut|קַלּוּת
lekalel|לְקַלֵּל
lehakel|לְהָקֵל
klala|קְלָלָה
kal|קַל
lehikalea|לְהִיקָּלֵעַ
kela|קֶלַע
kala|קָלָע
maklea|מַקְלֵעַ
kalia|קָלִיעַ
likloa|לִקְלוֹעַ
lekalef|לְקַלֵּף
liklof|לִקְלוֹף
lehitkalef|לְהִתְקַלֵּף
lehaklik|לְהַקְלִיק
lekalkel|לְקַלְקֵל
lehitkalkel|לְהִתְקַלְקֵל
kilshon|קִלְשׁוֹן
kemach|קֶמַח
lekamet|לְקַמֵּט
lehitkamet|לְהִתְקַמֵּט
lehikamel|לְהִיקָּמֵל
lekametz|לְקַמֵּץ
kamtzan|קַמְצָן
kometz|קוֹמֶץ
likmotz|לִקְמוֹץ
lehitkametz|לְהִתְקַמֵּץ
lehitkamtzen|לְהִתְקַמְצֵן
kmira|קְמִירָה
kamur|קָמוּר
lekamer|לְקַמֵּר
kemer|קֶמֶר
kin'a|קִנְאָה
kana|קַנָּא
kanay|קַנַּאי
kana'ut|קַנָּאוּת
lekane|לְקַנֵּא
lehitkane|לְהִתְקַנֵּא
lekaneach|לְקַנֵּחַ
lehaknit|לְהַקְנִיט
haknata|הַקְנָטָה
lekanter|לְקַנְטֵר
liknot|לִקְנוֹת
lehikanot|לְהִיקָּנוֹת
lehaknot|לְהַקְנוֹת
kniya|קְנִיָּה
kanuy|קָנוּי
kanyon|קַנְיוֹן
kanyon|קַנְיוֹן
lekanen|לְקַנֵּן
liknos|לִקְנוֹס
lehikanes|לְהִיקָּנֵס
liksom|לִקְסוֹם
lehaksim|לְהַקְסִים
kesem|קֶסֶם
leka'akea|לְקַעְקֵעַ
ka'ur|קָעוּר
ke'ira|קְעִירָה
ke'ara|קְעָרָה
lehikafe|לְהִיקָּפֵא
lehakpi|לְהַקְפִּיא
hakpa'a|הַקְפָּאָה
kipa'on|קִיפָּאוֹן
likpo|לִקְפּוֹא
lekaped|לְקַפֵּד
lehakpid|לְהַקְפִּיד
kafe|קָפֶה
mekupach|מְקוּפָּח
lekapeach|לְקַפֵּחַ
likpoach|לִקְפּוֹחַ
lekapot|לְקַפּוֹת
lekapel|לְקַפֵּל
lehitkapel|לְהִתְקַפֵּל
kipul|קִיפּוּל
lehakpitz|לְהַקְפִּיץ
kfitz|קְפִיץ
likpotz|לִקְפּוֹץ
lekapetz|לְקַפֵּץ
lehaktziv|לְהַקְצִיב
ketzev|קֶצֶב
katzav|קַצָּב
kitzba|קִצְבָּה
taktziv|תַּקְצִיב
katzuv|קָצוּב
ktzuba|קְצוּבָּה
liktzov|לִקְצוֹב
kitzba|קִצְבָּה
lehaktzot|לְהַקְצוֹת
lehaktzin|לְהַקְצִין
katzin|קָצִין
miktzo'i|מִקְצוֹעִי
lehaktzia|לְהַקְצִיעַ
miktzoa|מִקְצוֹעַ
katzefet|קַצֶּפֶת
ketzef|קֶצֶף
liktzof|לִקְצוֹף
ketzef|קֶצֶף
lehaktzif|לְהַקְצִיף
lekatzetz|לְקַצֵּץ
liktzotz|לִקְצוֹץ
katzir|קָצִיר
liktzor|לִקְצוֹר
lehikatzer|לְהִיקָּצֵר
lekatzer|לְקַצֵּר
lehitkatzer|לְהִתְקַצֵּר
katzar|קָצָר
ketzer|קֶצֶר
katzeret|קַצֶּרֶת
kitzur|קִיצּוּר
ktzat|קְצָת
likro|לִקְרוֹא
lehikare|לְהִיקָּרֵא
lehakri|לְהַקְרִיא
kri'a|קְרִיאָה
likrov|לִקְרוֹב
lekarev|לְקָרֵב
lehitkarev|לְהִתְקָרֵב
lehakriv|לְהַקְרִיב
hakrava|הַקְרָבָה
kirva|קִרְבָה
karov|קָרוֹב
takriv|תַּקְרִיב
korban|קוֹרְבָּן
lehakriach|לְהַקְרִיחַ
kerach|קֶרַח
kereach|קֵירֵחַ
karachat|קָרַחַת
lehikarot|לְהִיקָּרוֹת
likrot|לִקְרוֹת
lekarot|לְקָרוֹת
mikre|מִקְרֶה
kirya|קִרְיָה
takrit|תַּקְרִית
tikra|תִּקְרָה
karyan|קַרְייָן
lehakrim|לְהַקְרִים
lehikarem|לְהִיקָּרֵם
likrom|לִקְרוֹם
likron|לִקְרוֹן
lehakrin|לְהַקְרִין
hakrana|הַקְרָנָה
keren|קֶרֶן
keren|קֶרֶן
krina|קְרִינָה
likros|לִקְרוֹס
likroa|לִקְרוֹעַ
lehikarea|לְהִיקָּרֵעַ
karua|קָרוּעַ
likrotz|לִקְרוֹץ
lekartzef|לְקַרְצֵף
lekarkea|לְקַרְקֵעַ
karka|קַרְקַע
karkefet|קַרְקֶפֶת
kirkuf|קִירְקוּף
lekarkef|לְקַרְקֵף
lekarker|לְקַרְקֵר
karir|קָרִיר
lekarer|לְקָרֵר
kar|קַר
lehitkarer|לְהִתְקָרֵר
kor|קוֹר
lehitkaresh|לְהִתְקָרֵשׁ
lehakrish|לְהַקְרִישׁ
keresh|קֶרֶשׁ
hakshava|הַקְשָׁבָה
lehakshiv|לְהַקְשִׁיב
kashuv|קַשּׁוּב
lehakshiach|לְהַקְשִׁיחַ
lekashet|לְקַשֵּׁט
lehitkashet|לְהִתְקַשֵּׁט
likshot|לִקְשׁוֹט
lehitkashot|לְהִתְקַשּׁוֹת
lehakshot|לְהַקְשׁוֹת
kashe|קָשֶׁה
koshi|קוֹשִׁי
likshot|לִקְשׁוֹת
lekashkesh|לְקַשְׁקֵשׁ
lehikasher|לְהִיקָּשֵׁר
lekasher|לְקַשֵּׁר
kesher|קֶשֶׁר
heksher|הֶקְשֵׁר
tikshoret|תִּקְשׁוֹרֶת
kashur|קָשׁוּר
lehitkasher|לְהִתְקַשֵּׁר
likshor|לִקְשׁוֹר
kishur|קִישּׁוּר
kishur|קִישּׁוּר
lekoshesh|לְקוֹשֵׁשׁ
lekashet|לְקַשֵּׁת
re'ayon|רֵיאָיוֹן
lir'ot|לִרְאוֹת
lehera'ot|לְהֵירָאוֹת
lehar'ot|לְהַרְאוֹת
ra'uy|רָאוּי
nir'e|נִרְאֶה
mar'a|מַרְאָה
lehitra'ot|לְהִתְרָאוֹת
lerayen|לְרַאְייֵן
lehitrayen|לְהִתְרַאְייֵן
bereshit|בְּרֵאשִׁית
reshit|רֵאשִׁית
reshit|רֵאשִׁית
rosh|רֹאשׁ
rishon|רִאשׁוֹן
bereshit|בְּרֵאשִׁית
rov|רוֹב
ribit|רִיבִּית
rav|רַב
ribud|רִיבּוּד
lerabed|לְרַבֵּד
tarbut|תַּרְבּוּת
leharbot|לְהַרְבּוֹת
lehitrabot|לְהִתְרַבּוֹת
lirbot|לִרְבּוֹת
harbe|הַרְבֵּה
ribuy|רִיבּוּי
reva|רֶבַע
ravua|רָבוּעַ
revi'i|רְבִיעִי
lerabea|לְרַבֵּעַ
ribua|רִיבּוּעַ
rova|רוֹבַע
lirbotz|לִרְבּוֹץ
leharbitz|לְהַרְבִּיץ
lehitravrev|לְהִתְרַבְרֵב
lirgoz|לִרְגּוֹז
lehargiz|לְהַרְגִּיז
leheragez|לְהֵירָגֵז
lehitragez|לְהִתְרַגֵּז
leragel|לְרַגֵּל
lehargil|לְהַרְגִּיל
rigul|רִיגּוּל
hergel|הֶרְגֵּל
ragil|רָגִיל
regel|רֶגֶל
targil|תַּרְגִּיל
lehitragel|לְהִתְרַגֵּל
lirgom|לִרְגּוֹם
margema|מַרְגֵּמָה
lehargia|לְהַרְגִּיעַ
leheragea|לְהֵירָגֵעַ
harga'a|הַרְגָּעָה
ragua|רָגוּעַ
rega|רֶגַע
leheragesh|לְהֵירָגֵשׁ
lehargish|לְהַרְגִּישׁ
leragesh|לְרַגֵּשׁ
lehitragesh|לְהִתְרַגֵּשׁ
hargasha|הַרְגָּשָׁה
hitragshut|הִתְרַגְּשׁוּת
regesh|רֶגֶשׁ
margash|מַרְגָּשׁ
ragish|רָגִישׁ
lirgosh|לִרְגּוֹשׁ
leraded|לְרַדֵּד
radud|רָדוּד
radud|רָדוּד
lirdot|לִרְדּוֹת
heradmut|הֵירָדְמוּת
leheradem|לְהֵירָדֵם
lehardim|לְהַרְדִּים
tardema|תַּרְדֵּמָה
lirdof|לִרְדּוֹף
leheradef|לְהֵירָדֵף
leharhiv|לְהַרְהִיב
lerahet|לְרַהֵט
rahat|רַהַט
rahit|רָהִיט
lirhot|לִרְהוֹט
rihut|רִיהוּט
meruvach|מְרוּוָּח
lirvoach|לִרְווֹחַ
leraveach|לְרַווֵּחַ
leharviach|לְהַרְווִיחַ
mirvach|מִרְווָח
ruach|רוּחַ
lehitraveach|לְהִתְרַווֵּחַ
lirvot|לִרְווֹת
leharvot|לְהַרְווֹת
leharim|לְהָרִים
rama|רָמָה
lehitromem|לְהִתְרוֹמֵם
leromem|לְרוֹמֵם
truma|תְּרוּמָה
leharia|לְהָרִיעַ
larutz|לָרוּץ
lehitrotzetz|לְהִתְרוֹצֵץ
ritza|רִיצָה
meritza|מְרִיצָה
ratz|רָץ
leharitz|לְהָרִיץ
ravak|רַווָּק
lirzot|לִרְזוֹת
leharzot|לְהַרְזוֹת
harzaya|הַרְזָיָה
raze|רָזֶה
lirchov|לִרְחוֹב
leharchiv|לְהַרְחִיב
lehitrachev|לְהִתְרַחֵב
rechava|רְחָבָה
harchava|הַרְחָבָה
rachav|רָחָב
rochav|רוֹחַב
rechov|רְחוֹב
lerachem|לְרַחֵם
lehitrachem|לְהִתְרַחֵם
lerachef|לְרַחֵף
lirchotz|לִרְחוֹץ
leherachetz|לְהֵירָחֵץ
rechitza|רְחִיצָה
tarchitz|תַּרְחִיץ
lehitrachetz|לְהִתְרַחֵץ
leharchik|לְהַרְחִיק
harchaka|הַרְחָקָה
rachok|רָחוֹק
merchak|מֶרְחָק
lehitrachek|לְהִתְרַחֵק
lerachreach|לְרַחְרֵחַ
lirchosh|לִרְחוֹשׁ
lehitrachesh|לְהִתְרַחֵשׁ
leheratev|לְהֵירָטֵב
lehartiv|לְהַרְטִיב
lehitratev|לְהִתְרַטֵּב
ratov|רָטוֹב
lehartit|לְהַרְטִיט
lirtot|לִרְטוֹט
leratet|לְרַטֵּט
lirton|לִרְטוֹן
leratesh|לְרַטֵּשׁ
lariv|לָרִיב
meriva|מְרִיבָה
lehariach|לְהָרִיחַ
reach|רֵיחַ
rimon|רִימּוֹן
rek|רֵיק
leharik|לְהָרִיק
rik|רִיק
leroken|לְרוֹקֵן
lehitroken|לְהִתְרוֹקֵן
larir|לָרִיר
leroshesh|לְרוֹשֵׁשׁ
lehitroshesh|לְהִתְרוֹשֵׁשׁ
lehitrakev|לְהִתְרַכֵּב
tirkovet|תִּרְכּוֹבֶת
lirkov|לִרְכּוֹב
hitrakvut|הִתְרַכְּבוּת
herkev|הֶרְכֵּב
harkava|הַרְכָּבָה
murkav|מוּרְכָּב
merukav|מְרוּכָּב
rechev|רֶכֶב
rakevet|רַכֶּבֶת
rechiv|רְכִיב
merkava|מֶרְכָּבָה
leharkiv|לְהַרְכִּיב
lerakez|לְרַכֵּז
lehitrakez|לְהִתְרַכֵּז
tarkiz|תַּרְכִּיז
merkaz|מֶרְכָּז
rakaz|רַכָּז
lerakech|לְרַכֵּךְ
lehitrakech|לְהִתְרַכֵּךְ
rikuch|רִיכּוּךְ
rach|רַךְ
lerachel|לְרַכֵל
lirkol|לִרְכּוֹל
lirkon|לִרְכּוֹן
leharkin|לְהַרְכִּין
lirkos|לִרְכּוֹס
lirkosh|לִרְכּוֹשׁ
leherachesh|לְהֵירָכֵשׁ
rechisha|רְכִישָׁה
rechesh|רֶכֶשׁ
leramez|לְרַמֵּז
lirmoz|לִרְמוֹז
leheramez|לְהֵירָמֵז
remez|רֶמֶז
romach|רוֹמַח
leramot|לְרַמּוֹת
lirmot|לִרְמוֹת
mirma|מִרְמָה
ramay|רַמַּאי
lirmos|לִרְמוֹס
leherames|לְהֵירָמֵס
lirmos|לִרְמוֹשׂ
renana|רְנָנָה
rina|רִינָּה
lehitronen|לְהִתְרוֹנֵן
leranen|לְרַנֵּן
lerasen|לְרַסֵּן
lerases|לְרַסֵּס
lerasek|לְרַסֵּק
lehitrasek|לְהִתְרַסֵּק
hitraskut|הִתְרַסְּקוּת
resek|רֶסֶק
rea|רֵעַ
lir'ov|לִרְעוֹב
lehar'iv|לְהַרְעִיב
ra'av|רָעָב
ra'ev|רָעֵב
re'avtan|רְעַבְתָּן
lir'od|לִרְעוֹד
lehar'id|לְהַרְעִיד
ra'ad|רַעַד
lehera'ed|לְהֵירָעֵד
lir'ot|לִרְעוֹת
ra'ayon|רַעֲיוֹן
lehar'il|לְהַרְעִיל
har'ala|הַרְעָלָה
ra'al|רַעַל
ra'il|רָעִיל
tar'ela|תַּרְעֵלָה
lir'om|לִרְעוֹם
lehar'im|לְהַרְעִים
ra'am|רַעַם
lehitra'em|לְהִתְרַעֵם
lera'anen|לְרַעְנֵן
lehitra'anen|לְהִתְרַעְנֵן
ri'anun|רִיעְנוּן
leharea|לְהָרֵעַ
lehitro'ea|לְהִתְרוֹעֵעַ
ra|רַע
lehar'if|לְהַרְעִיף
ra'af|רַעַף
lir'otz|לִרְעוֹץ
lehera'etz|לְהֵירָעֵץ
lir'osh|לִרְעוֹשׁ
lehera'esh|לְהֵירָעֵשׁ
lehar'ish|לְהַרְעִישׁ
ra'ash|רַעַשׁ
rofe|רוֹפֵא
lirpo|לִרְפּוֹא
leherafe|לְהֵירָפֵא
lehitrape|לְהִתְרַפֵּא
mirpa'a|מִרְפָּאָה
refu'a|רְפוּאָה
trufa|תְּרוּפָה
lerape|לְרַפֵּא
leraped|לְרַפֵּד
lehitrapet|לְהִתְרַפֵּט
lerapet|לְרַפֵּט
lirpot|לִרְפּוֹת
lerapot|לְרַפּוֹת
leharpot|לְהַרְפּוֹת
rifyon|רִפְיוֹן
lehitrapes|לְהִתְרַפֵּס
mirpeset|מִרְפֶּסֶת
lehitrofef|לְהִתְרוֹפֵף
marpek|מַרְפֵּק
lehitrapek|לְהִתְרַפֵּק
lerafref|לְרַפְרֵף
hartza'a|הַרְצָאָה
leratzed|לְרַצֵּד
retzach|רֶצַח
lirtzoach|לִרְצוֹחַ
leheratzeach|לְהֵירָצֵחַ
lirtzot|לִרְצוֹת
lehitratzot|לְהִתְרַצּוֹת
lehartzot|לְהַרְצוֹת
leratzot|לְרַצּוֹת
ratzon|רָצוֹן
retzini|רְצִינִי
retzini|רְצִינִי
martzea|מַרְצֵעַ
leratzef|לְרַצֵּף
ritzuf|רִיצּוּף
ritzpa|רִצְפָּה
ratzif|רָצִיף
ratzif|רָצִיף
lerotzetz|לְרוֹצֵץ
rak|רַק
lirkov|לִרְקוֹב
leherakev|לְהֵירָקֵב
rakav|רָקָב
rikavon|רִיקָּבוֹן
rakuv|רָקוּב
leharkiv|לְהַרְקִיב
lirkod|לִרְקוֹד
leraked|לְרַקֵּד
rikud|רִיקּוּד
rakdan|רַקְדָן
rakid|רָקִיד
leharkid|לְהַרְקִיד
lirkoach|לִרְקוֹחַ
lehitrakem|לְהִתְרַקֵּם
leherakem|לְהֵירָקֵם
rikma|רִקְמָה
lirkom|לִרְקוֹם
leharkia|לְהַרְקִיעַ
rakia|רָקִיעַ
mirka|מִרְקָע
lerakea|לְרַקֵּעַ
rakua|רָקוּעַ
lirkoa|לִרְקוֹעַ
raka|רַקָּה
leharshot|לְהַרְשׁוֹת
rashut|רָשׁוּת
reshut|רְשׁוּת
rishayon|רִישָּׁיוֹן
lehitrashel|לְהִתְרַשֵּׁל
leherashem|לְהֵירָשֵׁם
lehitrashem|לְהִתְרַשֵּׁם
leharshim|לְהַרְשִׁים
hitrashmut|הִתְרַשְּׁמוּת
rishmi|רִשְׁמִי
harshama|הַרְשָׁמָה
tarshim|תַּרְשִׁים
roshem|רוֹשֶׁם
reshima|רְשִׁימָה
lirshom|לִרְשׁוֹם
rashum|רָשׁוּם
leharshia|לְהַרְשִׁיעַ
rasha|רָשָׁע
resha|רֶשַׁע
rish'a|רִשְׁעָה
harsha'a|הַרְשָׁעָה
reshef|רֶשֶׁף
lirshof|לִרְשׁוֹף
lerashresh|לְרַשְׁרֵשׁ
leroshesh|לְרוֹשֵׁשׁ
leroshesh|לְרוֹשֵׁשׁ
reshet|רֶשֶׁת
lirtoach|לִרְתּוֹחַ
lehartiach|לְהַרְתִּיחַ
lehitrateach|לְהִתְרַתֵּחַ
leratot|לְרַתּוֹת
leratech|לְרַתֵּךְ
lirtom|לִרְתּוֹם
leheratem|לְהֵירָתֵם
leheratea|לְהֵירָתֵעַ
lehartia|לְהַרְתִּיעַ
martef|מַרְתֵּף
leratek|לְרַתֵּק
meratek|מְרַתֵּק
lish'ov|לִשְׁאוֹב
lehisha'ev|לְהִישָּׁאֵב
mash'av|מַשְׁאָב
lish'og|לִשְׁאוֹג
lish'ol|לִשְׁאוֹל
lehash'il|לְהַשְׁאִיל
lehisha'el|לְהִישָּׁאֵל
she'ela|שְׁאֵלָה
hash'ala|הַשְׁאָלָה
mish'al|מִשְׁאָל
she'ila|שְׁאִילָה
lish'of|לִשְׁאוֹף
lehisha'ef|לְהִישָּׁאֵף
she'ifa|שְׁאִיפָה
lehisha'er|לְהִישָּׁאֵר
lehash'ir|לְהַשְׁאִיר
she'ar|שְׁאָר
se'or|שְׂאוֹר
shevach|שֶׁבַח
lehashbiach|לְהַשְׁבִּיחַ
leshabeach|לְשַׁבֵּחַ
lehishtabeach|לְהִשְׁתַּבֵּחַ
leshabet|לְשַׁבֵּט
lehishavot|לְהִישָּׁבוֹת
lishbot|לִשְׁבּוֹת
shibolet|שִׁיבּוֹלֶת
shvil|שְׁבִיל
svi'a|שְׂבִיעָה
lisboa|לִשְׂבּוֹעַ
lehishavea|לְהִישָּׁבֵעַ
lehashbia|לְהַשְׁבִּיעַ
shvi'i|שְׁבִיעִי
shvu'a|שְׁבוּעָה
shavua|שָׁבוּעַ
lehasbia|לְהַשְׂבִּיעַ
lehishtabetz|לְהִשְׁתַּבֵּץ
mishbetzet|מִשְׁבֶּצֶת
leshabetz|לְשַׁבֵּץ
leshaber|לְשַׁבֵּר
lishbor|לִשְׁבּוֹר
lehishaver|לְהִישָּׁבֵר
mishbar|מִשְׁבָּר
mashber|מַשְׁבֵּר
shever|שֶׁבֶר
shavir|שָׁבִיר
shavur|שָׁבוּר
lehashbir|לְהַשְׁבִּיר
lehishtabesh|לְהִשְׁתַּבֵּשׁ
leshabesh|לְשַׁבֵּשׁ
lehashbit|לְהַשְׁבִּית
shvita|שְׁבִיתָה
shabat|שַׁבָּת
lishbot|לִשְׁבּוֹת
shgi'a|שְׁגִיאָה
nisgav|נִשְׂגָּב
lishgog|לִשְׁגּוֹג
lehashgiach|לְהַשְׁגִּיחַ
hashgacha|הַשְׁגָּחָה
lishgot|לִשְׁגּוֹת
shaguy|שָׁגוּי
shigayon|שִׁיגָּיוֹן
meshuga|מְשׁוּגָּע
lehishtagea|לְהִשְׁתַּגֵּעַ
leshagea|לְשַׁגֵּעַ
shiga'on|שִׁיגָּעוֹן
leshager|לְשַׁגֵּר
shagrir|שַׁגְרִיר
shagrirut|שַׁגְרִירוּת
lesagseg|לְשַׂגְשֵׂג
shod|שׁוֹד
lishdod|לִשְׁדּוֹד
lehishaded|לְהִישָּׁדֵד
sade|שָׂדֶה
leshadech|לְשַׁדֵּךְ
shadchan|שַׁדְכָן
lehishtadech|לְהִשְׁתַּדֵּךְ
leshadel|לְשַׁדֵּל
lehishtadel|לְהִשְׁתַּדֵּל
leshader|לְשַׁדֵּר
mashder|מַשְׁדֵּר
mishdar|מִשְׁדָּר
leshadreg|לְשַׁדְרֵג
lehishtadreg|לְהִשְׁתַּדְרֵג
se|שֶׂה
lishhot|לִשְׁהוֹת
lehashhot|לְהַשְׁהוֹת
lehishtahot|לְהִשְׁתַּהוֹת
hashhaya|הַשְׁהָיָה
leshahek|לְשַׁהֵק
mishva'a|מִשְׁווָאָה
hashva'a|הַשְׁווָאָה
lehashiv|לְהָשִׁיב
tshuva|תְּשׁוּבָה
mashov|מָשׁוֹב
shuv|שׁוּב
lehishtovev|לְהִשְׁתּוֹבֵב
shiva|שִׁיבָה
lashuv|לָשׁוּב
shovav|שׁוֹבָב
lasuach|לָשׂוּחַ
lashuach|לָשׁוּחַ
shita|שִׁיטָה
lashut|לָשׁוּט
leshotet|לְשׁוֹטֵט
lehashit|לְהָשִׁיט
lehishtavot|לְהִשְׁתַּוּוֹת
lishvot|לִשְׁווֹת
lehashvot|לְהַשְׁווֹת
leshavot|לְשַׁוּוֹת
shulchan|שׁוּלְחָן
shulayim|שׁוּלַייִם
leshavea|לְשַׁווֵּעַ
lashuf|לָשׁוּף
lehashvitz|לְהַשְׁווִיץ
leshavek|לְשַׁווֵּק
shuk|שׁוּק
shokolad|שׁוֹקוֹלָד
shokolada|שׁוֹקוֹלָדָה
shor|שׁוֹר
tshura|תְּשׁוּרָה
lashur|לָשׁוּר
lehishtazef|לְהִשְׁתַּזֵּף
lishzof|לִשְׁזוֹף
lishzor|לִשְׁזוֹר
leshached|לְשַׁחֵד
shochad|שׁוֹחַד
lehishtachavot|לְהִשְׁתַּחֲווֹת
lehashchiz|לְהַשְׁחִיז
leshachzer|לְשַׁחְזֵר
lishchot|לִשְׁחוֹט
lehishachet|לְהִישָּׁחֵט
lishchot|לִשְׁחוֹת
lischot|לִשְׂחוֹת
sachyan|שַׂחְייָן
mische|מִשְׂחֶה
lehishtachel|לְהִשְׁתַּחֵל
lehashchil|לְהַשְׁחִיל
shachum|שָׁחוּם
lehashchim|לְהַשְׁחִים
shachefet|שַׁחֶפֶת
shachatz|שַׁחַץ
shachtzan|שַׁחְצָן
lesachek|לְשַׂחֵק
lishchok|לִשְׁחוֹק
lehishachek|לְהִישָּׁחֵק
mischak|מִשְׂחָק
sachkan|שַׂחְקָן
shachuk|שָׁחוּק
lehashchir|לְהַשְׁחִיר
hashchara|הַשְׁחָרָה
shachor|שָׁחוֹר
shachar|שַׁחַר
leshacher|לְשַׁחֵר
lehishtachrer|לְהִשְׁתַּחְרֵר
leshachrer|לְשַׁחְרֵר
shichrur|שִׁיחְרוּר
lehishachet|לְהִישָּׁחֵת
lehashchit|לְהַשְׁחִית
leshachet|לְשַׁחֵת
lishtoach|לִשְׁטוֹחַ
shetach|שֶׁטַח
shatiach|שָׁטִיחַ
lehishtateach|לְהִשְׁתַּטֵּחַ
shatuach|שָׁטוּחַ
lehishtatot|לְהִשְׁתַּטּוֹת
leshatot|לְשַׁטּוֹת
shtut|שְׁטוּת
shote|שׁוֹטֶה
lishtof|לִשְׁטוֹף
lehishatef|לְהִישָּׁטֵף
shitafon|שִׁיטָּפוֹן
mishtar|מִשְׁטָר
shoter|שׁוֹטֵר
mishtara|מִשְׁטָרָה
leshater|לְשַׁטֵּר
shtrudel|שְׁטְרוּדֶל
seya|שֵׂיָה
lasiach|לָשִׂיחַ
lehasiach|לְהָשִׂיחַ
lesocheach|לְשׂוֹחֵחַ
sicha|שִׂיחָה
leshayet|לְשַׁייֵּט
shayat|שַׁייָּט
shiyut|שִׁיּוּט
leshayech|לְשַׁייֵּךְ
lehishtayech|לְהִשְׁתַּייֵּךְ
shayach|שַׁייָּךְ
lasim|לָשִׂים
lehasim|לְהָשִׂים
mesima|מְשִׂימָה
hasama|הֲשָׂמָה
leshayef|לְשַׁייֵּף
lashir|לָשִׁיר
leshorer|לְשׁוֹרֵר
mushar|מוּשָׁר
shir|שִׁיר
shira|שִׁירָה
lasus|לָשׂוּשׂ
shishi|שִׁישִּׁי
lehashit|לְהָשִׁית
lashit|לָשִׁית
lishkav|לִשְׁכַּב
mishkav|מִשְׁכָּב
lehashkiv|לְהַשְׁכִּיב
shichva|שִׁכְבָה
lishkoach|לִשְׁכּוֹחַ
shachiach|שָׁכִיחַ
lehishacheach|לְהִישָּׁכֵחַ
lehashkiach|לְהַשְׁכִּיחַ
lehishtakeach|לְהִשְׁתַּכֵּחַ
shchichut|שְׁכִיחוּת
lashoch|לָשׁוֹךְ
leshakech|לְשַׁכֵּךְ
lishkol|לִשְׁכּוֹל
lehaskil|לְהַשְׂכִּיל
sechel|שֵׂכֶל
shakul|שַׁכּוּל
schaltan|שְׂכַלְתָּן
leshachlel|לְשַׁכְלֵל
lehishtachlel|לְהִשְׁתַּכְלֵל
meshuchlal|מְשׁוּכְלָל
shichlul|שִׁיכְלוּל
hishtachlelut|הִשְׁתַּכְלְלוּת
lehashkim|לְהַשְׁכִּים
lishkon|לִשְׁכּוֹן
lehashkin|לְהַשְׁכִּין
lehishtaken|לְהִשְׁתַּכֵּן
shachen|שָׁכֵן
shchuna|שְׁכוּנָה
mishtaken|מִשְׁתַּכֵּן
leshaken|לְשַׁכֵּן
leshachnea|לְשַׁכְנֵעַ
lehishtachnea|לְהִשְׁתַּכְנֵעַ
leshachpel|לְשַׁכְפֵּל
liskor|לִשְׂכּוֹר
lehisacher|לְהִישָּׂכֵר
lehaskir|לְהַשְׂכִּיר
lehistaker|לְהִשְׂתַּכֵּר
maskoret|מַשְׂכּוֹרֶת
haskara|הַשְׂכָּרָה
schira|שְׂכִירָה
sachar|שָׂכָר
lehishtaker|לְהִשְׁתַּכֵּר
lehashkish|לְהַשְׁכִּישׁ
lehishtachshech|לְהִשְׁתַּכְשֵׁךְ
leshachshech|לְשַׁכְשֵׁךְ
leshachtev|לְשַׁכְתֵּב
shel|שֶׁל
leshalev|לְשַׁלֵּב
tishlovet|תִּשְׁלוֹבֶת
shalav|שָׁלָב
mishlav|מִשְׁלָב
shiluv|שִׁילּוּב
lehishtalev|לְהִשְׁתַּלֵּב
sheleg|שֶׁלֶג
mushlag|מוּשְׁלָג
ashlag|אַשְׁלָג
ashlegan|אַשְׁלְגַן
leshalhev|לְשַׁלְהֵב
shalhevet|שַׁלְהֶבֶת
lehishtalhev|לְהִשְׁתַּלְהֵב
shalva|שַׁלְווָה
shalev|שָׁלֵו
lehishaleach|לְהִישָּׁלֵחַ
lehishtaleach|לְהִשְׁתַּלֵּחַ
shaluach|שָׁלוּחַ
lishloach|לִשְׁלוֹחַ
leshaleach|לְשַׁלֵּחַ
shaliach|שָׁלִיחַ
lishlot|לִשְׁלוֹט
lehishalet|לְהִישָּׁלֵט
lehashlit|לְהַשְׁלִיט
shalit|שַׁלִּיט
shalit|שַׁלִּיט
shilton|שִׁלְטוֹן
shelet|שֶׁלֶט
lehishtalet|לְהִשְׁתַּלֵּט
lehashlit|לְהַשְׁלִיט
shalat|שַׁלָּט
leshaltet|לְשַׁלְטֵט
lishlot|לִשְׁלוֹת
lehishalot|לְהִישָּׁלוֹת
lehashlot|לְהַשְׁלוֹת
ashlaya|אַשְׁלָיָה
lehashlich|לְהַשְׁלִיךְ
hashlacha|הַשְׁלָכָה
shalechet|שַׁלֶּכֶת
lehishalel|לְהִישָּׁלֵל
lehishtolel|לְהִשְׁתּוֹלֵל
shlili|שְׁלִילִי
hishtolelut|הִשְׁתּוֹלְלוּת
lishlol|לִשְׁלוֹל
lehishtalem|לְהִשְׁתַּלֵּם
lehashlim|לְהַשְׁלִים
leshalem|לְשַׁלֵּם
lishlom|לִשְׁלוֹם
shalom|שָׁלוֹם
shalem|שָׁלֵם
tashlum|תַּשְׁלוּם
hashlama|הַשְׁלָמָה
lehishalem|לְהִישָּׁלֵם
hishtalmut|הִשְׁתַּלְּמוּת
lehishalef|לְהִישָּׁלֵף
lishlof|לִשְׁלוֹף
shlif|שְׁלִיף
lishlok|לִשְׁלוֹק
leshalesh|לְשַׁלֵּשׁ
shlishi|שְׁלִישִׁי
shlish|שְׁלִישׁ
shilshom|שִׁלְשׁוֹם
lehishtalshel|לְהִשְׁתַּלְשֵׁל
shalshelet|שַׁלְשֶׁלֶת
leshalshel|לְשַׁלְשֵׁל
sham|שָׁם
shem|שֵׁם
lehishamed|לְהִישָּׁמֵד
lehashmid|לְהַשְׁמִיד
hashmada|הַשְׁמָדָה
lehishtamed|לְהִשְׁתַּמֵּד
lismoach|לִשְׂמוֹחַ
lesameach|לְשַׂמֵּחַ
simcha|שִׂמְחָה
sameach|שָׂמֵחַ
lishmot|לִשְׁמוֹט
lehishamet|לְהִישָּׁמֵט
lehashmit|לְהַשְׁמִיט
lehishtamet|לְהִשְׁתַּמֵּט
shamay|שַׁמַּאי
shamayim|שָׁמַיִם
smicha|שְׂמִיכָה
simla|שִׂמְלָה
lehishtomem|לְהִשְׁתּוֹמֵם
lehishom|לְהִישּׁוֹם
lehashem|לְהָשֵׁם
lashom|לָשׁוֹם
lehashmin|לְהַשְׁמִין
shamen|שָׁמֵן
leshamen|לְשַׁמֵּן
lishmon|לִשְׁמוֹן
shemen|שֶׁמֶן
shamenet|שַׁמֶּנֶת
shmini|שְׁמִינִי
lishmoa|לִשְׁמוֹעַ
lehishamea|לְהִישָּׁמֵעַ
lehashmia|לְהַשְׁמִיעַ
lehishtamea|לְהִשְׁתַּמֵּעַ
mashma'uti|מַשְׁמָעוּתִי
shmu'a|שְׁמוּעָה
mishma'at|מִשְׁמַעַת
mashma|מַשְׁמָע
mashma'ut|מַשְׁמָעוּת
lehashmitz|לְהַשְׁמִיץ
lehishamer|לְהִישָּׁמֵר
leshamer|לְשַׁמֵּר
lehishtamer|לְהִשְׁתַּמֵּר
mishmeret|מִשְׁמֶרֶת
mishmar|מִשְׁמָר
shmira|שְׁמִירָה
shamur|שָׁמוּר
lishmor|לִשְׁמוֹר
shimur|שִׁימּוּר
leshamesh|לְשַׁמֵּשׁ
shamish|שָׁמִישׁ
lehishtamesh|לְהִשְׁתַּמֵּשׁ
shimushi|שִׁימּוּשִׁי
shemesh|שֵׁמֶשׁ
shimush|שִׁימּוּשׁ
tashmish|תַּשְׁמִישׁ
lehasni|לְהַשְׂנִיא
lisno|לִשְׂנוֹא
sin'a|שִׂנְאָה
shana|שָׁנָה
shenhabi|שֶׁנְהַבִּי
shenhav|שֶׁנְהָב
shanhevet|שַׁנְהֶבֶת
shinuy|שִׁינּוּי
leshanot|לְשַׁנּוֹת
lehishtanot|לְהִשְׁתַּנּוֹת
tashnit|תַּשְׁנִית
lishnot|לִשְׁנוֹת
lehishanot|לְהִישָּׁנוֹת
shoni|שׁוֹנִי
sheni|שֵׁנִי
meshune|מְשׁוּנֶּה
leshanen|לְשַׁנֵּן
shen|שֵׁן
leshanea|לְשַׁנֵּעַ
lehishtanek|לְהִשְׁתַּנֵּק
lehishanek|לְהִישָּׁנֵק
leshanek|לְשַׁנֵּק
leshasot|לְשַׁסּוֹת
leshasea|לְשַׁסֵּעַ
lishsoa|לִשְׁסוֹעַ
leshasef|לְשַׁסֵּף
lehishta'abed|לְהִשְׁתַּעְבֵּד
hishta'abdut|הִשְׁתַּעְבְּדוּת
lesha'abed|לְשַׁעְבֵּד
shi'abud|שִׁיעְבּוּד
lish'ot|לִשְׁעוֹט
lish'ot|לִשְׁעוֹת
lehash'ot|לְהַשְׁעוֹת
sha'on|שָׁעוֹן
sha'a|שָׁעָה
lehishta'el|לְהִשְׁתַּעֵל
mish'ol|מִשְׁעוֹל
lesha'amem|לְשַׁעְמֵם
lehishta'amem|לְהִשְׁתַּעְמֵם
meshu'amam|מְשׁוּעְמָם
mesha'amem|מְשַׁעְמֵם
lehash'in|לְהַשְׁעִין
lehisha'en|לְהִישָּׁעֵן
lesha'er|לְשַׁעֵר
shi'ur|שִׁיעוּר
sha'ar|שַׁעַר
sho'er|שׁוֹעֵר
se'ar|שֵׂיעָר
sa'ara|שַׂעֲרָה
sa'ir|שָׂעִיר
lehas'ir|לְהַשְׂעִיר
lesha'ashea|לְשַׁעְשֵׁעַ
lehishta'ashea|לְהִשְׁתַּעְשֵׁעַ
sha'ashua|שַׁעְשׁוּעַ
lesha'atek|לְשַׁעְתֵּק
mishpacha|מִשְׁפָּחָה
lishpot|לִשְׁפּוֹט
lehishafet|לְהִישָּׁפֵט
shiput|שִׁיפּוּט
mishpat|מִשְׁפָּט
mishpati|מִשְׁפָּטִי
shafuy|שָׁפוּי
safa|שָׂפָה
safa|שָׂפָה
lehishafech|לְהִישָּׁפֵךְ
shafuch|שָׁפוּךְ
lehishtapech|לְהִשְׁתַּפֵּךְ
lishpoch|לִשְׁפּוֹךְ
lishpol|לִשְׁפּוֹל
lehashpil|לְהַשְׁפִּיל
hashpala|הַשְׁפָּלָה
lehishtapel|לְהִשְׁתַּפֵּל
safam|שָׂפָם
mesupam|מְשׂוּפָּם
shafan|שָׁפָן
lehishtafen|לְהִשְׁתַּפֵן
lishpoa|לִשְׁפּוֹעַ
lehashpia|לְהַשְׁפִּיעַ
hashpa'a|הַשְׁפָּעָה
shefa|שֶׁפַע
shif'a|שִׁפְעָה
shapa'at|שַׁפַּעַת
leshapea|לְשַׁפֵּעַ
shipua|שִׁיפּוּעַ
meshupa|מְשׁוּפָּע
leshaf'el|לְשַׁפְעֵל
lehishtaf'el|לְהִשְׁתַּפְעֵל
leshapetz|לְשַׁפֵּץ
shiputz|שִׁיפּוּץ
shipur|שִׁיפּוּר
leshaper|לְשַׁפֵּר
lehishtaper|לְהִשְׁתַּפֵּר
lehashpritz|לְהַשְׁפְּרִיץ
leshafshef|לְשַׁפְשֵׁף
lehishtafshef|לְהִשְׁתַּפְשֵׁף
lishpot|לִשְׁפּוֹת
sak|שַׂק
lishkod|לִשְׁקוֹד
sheket|שֶׁקֶט
lehashkit|לְהַשְׁקִיט
shaket|שָׁקֵט
lishkot|לִשְׁקוֹט
lehashkot|לְהַשְׁקוֹת
hashkaya|הַשְׁקָיָה
mashke|מַשְׁקֶה
sakit|שַׂקִּית
lehishakel|לְהִישָּׁקֵל
shekel|שֶׁקֶל
mishkal|מִשְׁקָל
shikul|שִׁיקּוּל
shkila|שְׁקִילָה
lishkol|לִשְׁקוֹל
leshaklel|לְשַׁקְלֵל
shiklul|שִׁיקְלוּל
leshakem|לְשַׁקֵּם
lehishtakem|לְהִשְׁתַּקֵּם
shikum|שִׁיקּוּם
lishkoa|לִשְׁקוֹעַ
lehashkia|לְהַשְׁקִיעַ
sheka|שֶׁקַע
hashka'a|הַשְׁקָעָה
lehishtakea|לְהִשְׁתַּקֵּעַ
lehishakef|לְהִישָּׁקֵף
leshakef|לְשַׁקֵּף
lehishtakef|לְהִשְׁתַּקֵּף
lehashkif|לְהַשְׁקִיף
shekef|שֶׁקֶף
shkufit|שְׁקוּפִית
hashkafa|הַשְׁקָפָה
shikuf|שִׁיקּוּף
shakuf|שָׁקוּף
mishkafayim|מִשְׁקָפַייִם
shikutz|שִׁיקּוּץ
lashok|לָשׁוֹק
lehishtokek|לְהִשְׁתּוֹקֵק
leshaker|לְשַׁקֵּר
shakran|שַׁקְרָן
sheker|שֶׁקֶר
leshakshek|לְשַׁקְשֵׁק
hashra'a|הַשְׁרָאָה
lesharbev|לְשַׁרְבֵּב
lehishtarbev|לְהִשְׁתַּרְבֵּב
lesharbet|לְשַׁרְבֵּט
sharvit|שַׁרְבִיט
lehistareg|לְהִשְׂתָּרֵג
lisrod|לִשְׂרוֹד
hisardut|הִישָּׂרְדוּת
misrad|מִשְׂרָד
lisrot|לִשְׂרוֹט
lehisaret|לְהִישָּׂרֵט
lesartet|לְשַׂרְטֵט
sirtut|שִׂירְטוּט
lehashrot|לְהַשְׁרוֹת
misra|מִשְׂרָה
lishrot|לִשְׁרוֹת
lisrot|לִשְׂרוֹת
lesharyen|לְשַׁרְייֵן
sroch|שְׂרוֹךְ
lisroch|לִשְׂרוֹךְ
sroch|שְׂרוֹךְ
saruch|שָׂרוּךְ
lehistarech|לְהִשְׂתָּרֵךְ
lehistarea|לְהִשְׂתָּרֵעַ
lisrof|לִשְׂרוֹף
lehisaref|לְהִישָּׂרֵף
srefa|שְׂרֵיפָה
saraf|שָׂרָף
lishrotz|לִשְׁרוֹץ
lishrok|לִשְׁרוֹק
lisror|לִשְׂרוֹר
lehistarer|לְהִשְׂתָּרֵר
sar|שָׂר
lehishtaresh|לְהִשְׁתָּרֵשׁ
lehashrish|לְהַשְׁרִישׁ
lesharsher|לְשַׁרְשֵׁר
sharsheret|שַׁרְשֶׁרֶת
lesharet|לְשָׁרֵת
sherut|שֵׁירוּת
lishtot|לִשְׁתּוֹת
shatyan|שַׁתְייָן
shtiya|שְׁתִיָּה
lehishatot|לְהִישָּׁתוֹת
lishtol|לִשְׁתּוֹל
lehishatel|לְהִישָּׁתֵל
lehashtil|לְהַשְׁתִּיל
mashten|מַשְׁתֵּן
lehashtin|לְהַשְׁתִּין
sheten|שֶׁתֶן
leshatef|לְשַׁתֵּף
lehishtatef|לְהִשְׁתַּתֵּף
shituf|שִׁיתּוּף
meshutaf|מְשׁוּתָּף
lishtok|לִשְׁתּוֹק
leshatek|לְשַׁתֵּק
lehashtik|לְהַשְׁתִּיק
lehishtatek|לְהִשְׁתַּתֵּק
shtika|שְׁתִיקָה
lishtot|לִשְׁתּוֹת
lehashtit|לְהַשְׁתִּית
lit'ov|לִתְאוֹב
te'avon|תֵּיאָבוֹן
lit'om|לִתְאוֹם
leta'em|לְתָאֵם
lehat'im|לְהַתְאִים
hat'ama|הַתְאָמָה
te'om|תְּאוֹם
te'um|תֵּיאוּם
leta'er|לְתָאֵר
te'ur|תֵּיאוּר
to'ar|תּוֹאַר
leta'arech|לְתַאֲרֵךְ
letabel|לְתַבֵּל
tavlin|תַּבְלִין
tevel|תֵּבֵל
tevel|תֶּבֶל
litboa|לִתְבּוֹעַ
lehitavea|לְהִיתָּבֵעַ
tvi'a|תְּבִיעָה
tovea|תּוֹבֵעַ
letagber|לְתַגְבֵּר
letagmel|לְתַגְמֵל
letadlek|לְתַדְלֵק
teder|תֶּדֶר
letadrech|לְתַדְרֵךְ
lithot|לִתְהוֹת
tehiya|תְּהִיָּה
mitve|מִתְווֶה
tvay|תְּווַאי
lehatvot|לְהַתְווֹת
letavech|לְתַווֵּךְ
tivuch|תִּיוּוּךְ
tavech|תָּווֶךְ
latur|לָתוּר
tor|תּוֹר
tushiya|תּוּשִׁייָּה
letazmen|לְתַזְמֵן
tizmun|תִּיזְמוּן
litchov|לִתְחוֹב
lehitachev|לְהִיתָּחֵב
letachzek|לְתַחְזֵק
metuchkam|מְתוּחְכָּם
lehatchil|לְהַתְחִיל
hatchala|הַתְחָלָה
litchom|לִתְחוֹם
letachem|לְתַחֵם
mitcham|מִתְחָם
tchum|תְּחוּם
letachmen|לְתַחְמֵן
letachker|לְתַחְקֵר
tachat|תַּחַת
letayeg|לְתַייֵּג
tik|תִּיק
letayek|לְתַייֵּק
tikiya|תִּיקִייָּה
teko|תֵּיקוֹ
letayer|לְתַייֵּר
tayar|תַּייָּר
tayish|תַּיִשׁ
letaken|לְתַכֵּן
lehitachen|לְהִיתָּכֵן
tochna|תּוֹכְנָה
techen|תֶּכֶן
tochen|תּוֹכֶן
tochnit|תּוֹכְנִית
matkon|מַתְכּוֹן
litkon|לִתְכּוֹן
letachnen|לְתַכְנֵן
letachnet|לְתַכְנֵת
metachnet|מְתַכְנֵת
tichnut|תִּיכְנוּת
tchufot|תְּכוּפוֹת
tachuf|תָּכוּף
litkof|לִתְכּוֹף
litlot|לִתְלוֹת
lehitalot|לְהִיתָּלוֹת
lehatlot|לְהַתְלוֹת
tilyon|תִּלְיוֹן
tlut|תְּלוּת
taluy|תָּלוּי
litlosh|לִתְלוֹשׁ
lehitalesh|לְהִיתָּלֵשׁ
lehatmid|לְהַתְמִיד
matmid|מַתְמִיד
litmoah|לִתְמוֹהַּ
lehatmiah|לְהַתְמִיהַּ
letamcher|לְתַמְחֵר
tamid|תָּמִיד
lehitamech|לְהִיתָּמֵךְ
tmicha|תְּמִיכָה
litmoch|לִתְמוֹךְ
latom|לָתוֹם
tamim|תָּמִים
lehitamem|לְהִיתַּמֵּם
tam|תָּם
letamtzet|לְתַמְצֵת
lehitamer|לְהִיתַּמֵּר
letamren|לְתַמְרֵן
tnay|תְּנַאי
lehatnot|לְהַתְנוֹת
letanot|לְתַנּוֹת
tinyani|תִּנְייָנִי
lehatnia|לְהַתְנִיעַ
letaskel|לְתַסְכֵּל
tiskul|תִּיסְכּוּל
litsos|לִתְסוֹס
lehatsis|לְהַתְסִיס
leta'ev|לְתַעֵב
lehita'ev|לְהִיתָּעֵב
leta'ed|לְתַעֵד
ti'ud|תִּיעוּד
lit'ot|לִתְעוֹת
lehat'ot|לְהַתְעוֹת
leta'es|לְתַעֵשׂ
leta'atea|לְתַעְתֵּעַ
tapuz|תַּפּוּז
tficha|תְּפִיחָה
litpoach|לִתְפּוֹחַ
lehatpiach|לְהַתְפִּיחַ
lehatpil|לְהַתְפִּיל
tafel|תָּפֵל
hatpala|הַתְפָּלָה
litpos|לִתְפּוֹשׂ
lehitafes|לְהִיתָּפֵשׂ
tfisa|תְּפִיסָה
tafus|תָּפוּס
tif'uli|תִּיפְעוּלִי
tif'ul|תִּיפְעוּל
letaf'el|לְתַפְעֵל
letofef|לְתוֹפֵף
tof|תּוֹף
letafked|לְתַפְקֵד
tafur|תָּפוּר
litpor|לִתְפּוֹר
tfira|תְּפִירָה
tefer|תֶּפֶר
mitpara|מִתְפָּרָה
tfisa|תְּפִישָׂה
lehitakel|לְהִיתָּקֵל
lehatkil|לְהַתְקִיל
letaken|לְתַקֵּן
lehatkin|לְהַתְקִין
lehitaken|לְהִיתַּקֵּן
teken|תֶּקֶן
takin|תַּקִּין
hatkana|הַתְקָנָה
letaknen|לְתַקְנֵן
teka|תֶּקַע
litkoa|לִתְקוֹעַ
lehitakea|לְהִיתָּקֵעַ
tikuf|תִּיקּוּף
takef|תָּקֵף
lehatkif|לְהַתְקִיף
mitkafa|מִתְקָפָה
litkof|לִתְקוֹף
lehitakef|לְהִיתָּקֵף
tokef|תּוֹקֶף
hetkef|הֶתְקֵף
letakef|לְתַקֵּף
letaktzev|לְתַקְצֵב
tikshur|תִּיקְשׁוּר
letaksher|לְתַקְשֵׁר
tiktuk|תִּיקְתּוּק
letaktek|לְתַקְתֵּק
letargel|לְתַרְגֵּל
tirgul|תִּירְגּוּל
tirgum|תִּירְגּוּם
letargem|לְתַרְגֵּם
targum|תַּרְגּוּם
meturgeman|מְתוּרְגְּמָן
metargem|מְתַרְגֵּם
turgeman|תּוּרְגְּמָן
lehatrot|לְהַתְרוֹת
litrom|לִתְרוֹם
lehitarem|לְהִיתָּרֵם
lehatris|לְהַתְרִיס
tris|תְּרִיס
lehatria|לְהַתְרִיעַ
letaretz|לְתָרֵץ
terutz|תֵּירוּץ
letash'el|לְתַשְׁאֵל
tshi'i|תְּשִׁיעִי
tesher|תֶּשֶׁר
litshosh|לִתְשׁוֹשׁ
